日期,縣市,800KW以上售電量(度),800KW以上抄表戶數,800KW以上用電佔比(%),小於800KW售電量(度),小於800KW抄表戶數,小於800KW用電佔比(%),合計
2019年08月,新北市,250931618,216,0.4961,254838121,14803,0.5039,505769739
2019年08月,台北市,24635300,27,0.4891,25733622,2015,0.5109,50368922
2019年08月,桃園市,1362802265,746,0.8311,276948830,7205,0.1689,1639751095
2019年08月,台中市,1377707753,417,0.8354,271459494,12334,0.1646,1649167247
2019年08月,台南市,1484877960,414,0.873,216007718,10666,0.127,1700885678
2019年08月,高雄市,1328245470,539,0.89,164172184,6112,0.11,1492417654
2019年08月,宜蘭縣,107648004,62,0.7816,30071670,1241,0.2184,137719674
2019年08月,新竹縣,611194390,225,0.9115,59321895,1720,0.0885,670516285
2019年08月,苗栗縣,388150376,140,0.9,43137057,1286,0.1,431287433
2019年08月,彰化縣,347744768,293,0.6518,185809035,15802,0.3482,533553803
2019年08月,南投縣,72575850,92,0.7065,30145028,1148,0.2935,102720878
2019年08月,雲林縣,219266148,93,0.8328,44037331,2390,0.1672,263303479
2019年08月,嘉義縣,48729020,64,0.542,41179924,1987,0.458,89908944
2019年08月,屏東縣,64973928,123,0.6269,38669661,1684,0.3731,103643589
2019年08月,台東縣,8034201,3,0.7677,2430694,332,0.2323,10464895
2019年08月,花蓮縣,66507144,17,0.8575,11051228,568,0.1425,77558372
2019年08月,基隆市,9947890,15,0.5137,9416519,362,0.4863,19364409
2019年08月,新竹市,684142872,126,0.9545,32606118,1545,0.0455,716748990
2019年08月,嘉義市,2703792,5,0.3531,4954192,558,0.6469,7657984
2019年08月,澎湖縣,1708000,1,0.4118,2439415,253,0.5882,4147415
2019年08月,金門縣,2139400,3,0.5579,1695051,286,0.4421,3834451
2019年08月,連江縣,0,0,0,728902,59,1,728902
2019年08月,合計,8464666149,3621,0.8289,1746853689,84356,0.1711,10211519838
2019年07月,新北市,252634596,216,0.5155,237465050,14531,0.4845,490099646
2019年07月,台北市,23976100,26,0.5001,23969022,2009,0.4999,47945122
2019年07月,桃園市,1369504288,739,0.8406,259626812,6913,0.1594,1629131100
2019年07月,台中市,1402374942,414,0.8398,267592524,12310,0.1602,1669967466
2019年07月,台南市,1482481023,414,0.8732,215310596,10621,0.1268,1697791619
2019年07月,高雄市,1313321681,538,0.8875,166476941,6096,0.1125,1479798622
2019年07月,宜蘭縣,109144533,61,0.7842,30028650,1209,0.2158,139173183
2019年07月,新竹縣,620709509,225,0.9143,58156102,1717,0.0857,678865611
2019年07月,苗栗縣,382701584,141,0.8951,44842521,1278,0.1049,427544105
2019年07月,彰化縣,364605960,294,0.6698,179725440,15805,0.3302,544331400
2019年07月,南投縣,74506828,93,0.7149,29706360,1116,0.2851,104213188
2019年07月,雲林縣,216691004,93,0.8344,43018035,2357,0.1656,259709039
2019年07月,嘉義縣,50595760,64,0.5666,38707086,1956,0.4334,89302846
2019年07月,屏東縣,65925936,119,0.6333,38166376,1663,0.3667,104092312
2019年07月,台東縣,8504257,3,0.7668,2585871,332,0.2332,11090128
2019年07月,花蓮縣,70932124,17,0.8645,11118871,548,0.1355,82050995
2019年07月,基隆市,10409977,15,0.5329,9124011,362,0.4671,19533988
2019年07月,新竹市,682260481,126,0.9555,31778936,1544,0.0445,714039417
2019年07月,嘉義市,2701992,5,0.3934,4165489,555,0.6066,6867481
2019年07月,澎湖縣,1678800,1,0.4082,2433537,252,0.5918,4112337
2019年07月,金門縣,2509200,3,0.611,1597320,285,0.389,4106520
2019年07月,連江縣,0,0,0,670500,59,1,670500
2019年07月,合計,8508170575,3607,0.8338,1696266050,83518,0.1662,10204436625
2019年06月,新北市,231336402,215,0.5121,220397655,14475,0.4879,451734057
2019年06月,台北市,22902900,27,0.5104,21970066,2006,0.4896,44872966
2019年06月,桃園市,1293057050,742,0.8457,235918575,6887,0.1543,1528975625
2019年06月,台中市,1317413875,409,0.8417,247860243,12249,0.1583,1565274118
2019年06月,台南市,1400775520,412,0.8744,201240210,10614,0.1256,1602015730
2019年06月,高雄市,1285212321,538,0.8924,154893708,6093,0.1076,1440106029
2019年06月,宜蘭縣,101917481,60,0.8015,25235142,1188,0.1985,127152623
2019年06月,新竹縣,585163438,224,0.9102,57726479,1717,0.0898,642889917
2019年06月,苗栗縣,363316248,142,0.9034,38867575,1277,0.0966,402183823
2019年06月,彰化縣,339001044,290,0.6668,169411720,15807,0.3332,508412764
2019年06月,南投縣,68097420,91,0.7207,26384840,1106,0.2793,94482260
2019年06月,雲林縣,208157660,92,0.8391,39903382,2355,0.1609,248061042
2019年06月,嘉義縣,46889540,63,0.557,37298966,1947,0.443,84188506
2019年06月,屏東縣,60267320,115,0.6277,35741897,1622,0.3723,96009217
2019年06月,台東縣,7642700,3,0.7701,2282112,331,0.2299,9924812
2019年06月,花蓮縣,72515044,16,0.884,9514589,539,0.116,82029633
2019年06月,基隆市,9241825,15,0.5283,8251746,360,0.4717,17493571
2019年06月,新竹市,644746855,126,0.9563,29430904,1546,0.0437,674177759
2019年06月,嘉義市,2589432,5,0.3966,3939885,554,0.6034,6529317
2019年06月,澎湖縣,1435200,1,0.3547,2611308,252,0.6453,4046508
2019年06月,金門縣,2453000,3,0.6153,1533512,281,0.3847,3986512
2019年06月,連江縣,0,0,0,640196,59,1,640196
2019年06月,合計,8064132275,3589,0.8369,1571054710,83265,0.1631,9635186985
2019年05月,新北市,239439612,220,0.518,222812395,14456,0.482,462252007
2019年05月,台北市,23360100,28,0.5229,21312969,2007,0.4771,44673069
2019年05月,桃園市,1336576517,744,0.8451,244986727,6869,0.1549,1581563244
2019年05月,台中市,1367198820,406,0.8417,257186794,12241,0.1583,1624385614
2019年05月,台南市,1441249179,413,0.8713,212870962,10606,0.1287,1654120141
2019年05月,高雄市,1332180693,538,0.885,173066635,6074,0.115,1505247328
2019年05月,宜蘭縣,99627116,61,0.7947,25740672,1183,0.2053,125367788
2019年05月,新竹縣,587204904,224,0.9175,52788681,1717,0.0825,639993585
2019年05月,苗栗縣,398600830,142,0.9002,44176914,1277,0.0998,442777744
2019年05月,彰化縣,361895468,289,0.6713,177173453,15803,0.3287,539068921
2019年05月,南投縣,70281976,91,0.7169,27753350,1106,0.2831,98035326
2019年05月,雲林縣,219038132,93,0.8441,40465648,2345,0.1559,259503780
2019年05月,嘉義縣,47756400,63,0.5335,41765954,1943,0.4665,89522354
2019年05月,屏東縣,64904592,114,0.6352,37275316,1616,0.3648,102179908
2019年05月,台東縣,8423400,3,0.773,2473984,329,0.227,10897384
2019年05月,花蓮縣,72162693,16,0.8817,9683400,538,0.1183,81846093
2019年05月,基隆市,9290953,15,0.527,8338053,358,0.473,17629006
2019年05月,新竹市,648126728,126,0.9578,28545869,1541,0.0422,676672597
2019年05月,嘉義市,2736592,5,0.4038,4039871,553,0.5962,6776463
2019年05月,澎湖縣,1522000,1,0.3837,2444304,252,0.6163,3966304
2019年05月,金門縣,2172600,3,0.5958,1473917,279,0.4042,3646517
2019年05月,連江縣,0,0,0,612760,57,1,612760
2019年05月,合計,8333749305,3595,0.8358,1636988628,83150,0.1642,9970737933
2019年04月,新北市,224810701,216,0.517524835854484,209585265,14444,0.482475164145516,434395966
2019年04月,台北市,22134800,29,0.53240797977933,19440084,2003,0.46759202022067,41574884
2019年04月,桃園市,1250244019,743,0.840477065037171,237296892,6851,0.159522934962829,1487540911
2019年04月,台中市,1308870525,403,0.846663674088331,237045008,12238,0.153336325911669,1545915533
2019年04月,台南市,1362364027,411,0.875621294827133,193518676,10601,0.124378705172867,1555882703
2019年04月,高雄市,1304898387,539,0.879611331028446,178595903,6059,0.120388668971554,1483494290
2019年04月,宜蘭縣,88160997,60,0.785424687181384,24085280,1183,0.214575312818616,112246277
2019年04月,新竹縣,557405166,222,0.92036957783113,48226723,1718,0.0796304221688696,605631889
2019年04月,苗栗縣,331816442,140,0.892307723419213,40046799,1274,0.107692276580787,371863241
2019年04月,彰化縣,341824600,289,0.675678945216541,164073360,15791,0.324321054783459,505897960
2019年04月,南投縣,67777816,91,0.724793731899891,25735432,1092,0.275206268100109,93513248
2019年04月,雲林縣,208714472,92,0.849846875296734,36876208,2340,0.150153124703266,245590680
2019年04月,嘉義縣,42677604,64,0.538021408478687,36645641,1938,0.461978591521313,79323245
2019年04月,屏東縣,61339440,116,0.644849256857536,33782698,1607,0.355150743142464,95122138
2019年04月,台東縣,7697300,3,0.762239623666157,2400968,330,0.237760376333843,10098268
2019年04月,花蓮縣,72376744,16,0.883484490682945,9545174,540,0.116515509317055,81921918
2019年04月,基隆市,8997195,15,0.541433248721052,7620172,354,0.458566751278948,16617367
2019年04月,新竹市,619444199,125,0.959166264528954,26371049,1535,0.040833735471046,645815248
2019年04月,嘉義市,2633336,5,0.422363245068059,3601430,554,0.577636754931941,6234766
2019年04月,澎湖縣,1950800,2,0.543720168623489,1637075,250,0.456279831376511,3587875
2019年04月,金門縣,1223600,3,0.481959411580969,1315203,277,0.518040588419031,2538803
2019年04月,連江縣,0,0,0,587329,56,1,587329
2019年04月,合計,7887362170,3584,0.836820372597031,1538032369,83035,0.163179627402969,9425394539
2019年03月,新北市,238061500,217,0.5581,188481150,14441,0.4419,426542650
2019年03月,台北市,26797728,32,0.6023,17693593,2000,0.3977,44491321
2019年03月,桃園市,1278841434,748,0.855,216847929,6828,0.145,1495689363
2019年03月,台中市,1337444408,405,0.8579,221524886,12174,0.1421,1558969294
2019年03月,台南市,1359176514,413,0.8798,185766658,10570,0.1202,1544943172
2019年03月,高雄市,1320967764,540,0.8931,158123456,6035,0.1069,1479091220
2019年03月,宜蘭縣,107648496,60,0.8166,24171403,1182,0.1834,131819899
2019年03月,新竹縣,556218942,222,0.9255,44781323,1714,0.0745,601000265
2019年03月,苗栗縣,362151055,145,0.9057,37685702,1273,0.0943,399836757
2019年03月,彰化縣,347011602,288,0.689,156655060,15787,0.311,503666662
2019年03月,南投縣,64946012,91,0.7169,25648624,1093,0.2831,90594636
2019年03月,雲林縣,209048052,90,0.8541,35720916,2338,0.1459,244768968
2019年03月,嘉義縣,44453840,63,0.4758,48970796,1931,0.5242,93424636
2019年03月,屏東縣,59959200,116,0.6504,32235917,1600,0.3496,92195117
2019年03月,台東縣,8255200,3,0.7744,2404327,329,0.2256,10659527
2019年03月,花蓮縣,69768333,15,0.876,9875196,538,0.124,79643529
2019年03月,基隆市,8807723,14,0.5476,7276815,357,0.4524,16084538
2019年03月,新竹市,614424756,127,0.9619,24306551,1536,0.0381,638731307
2019年03月,嘉義市,2741120,5,0.4509,3338686,553,0.5491,6079806
2019年03月,澎湖縣,1979200,2,0.5691,1498389,249,0.4309,3477589
2019年03月,金門縣,906400,3,0.4271,1215728,277,0.5729,2122128
2019年03月,連江縣,0,0,0,605215,57,1,605215
2019年03月,合計,8019609279,3599,0.8473,1444828320,82862,0.1527,9464437599
2019年02月,新北市,179651589,215,0.5194,166259173,14434,0.4806,345910762
2019年02月,台北市,22779199,30,0.5734,16944921,1997,0.4266,39724120
2019年02月,桃園市,1051739604,745,0.8592,172384434,6801,0.1408,1224124038
2019年02月,台中市,1115125045,405,0.8588,183373563,12173,0.1412,1298498608
2019年02月,台南市,1154345360,411,0.8854,149402744,10570,0.1146,1303748104
2019年02月,高雄市,1136063321,539,0.8924,136943483,6026,0.1076,1273006804
2019年02月,宜蘭縣,71049016,60,0.7879,19123443,1188,0.2121,90172459
2019年02月,新竹縣,475932725,223,0.9237,39303008,1708,0.0763,515235733
2019年02月,苗栗縣,293570383,146,0.91,29028388,1271,0.09,322598771
2019年02月,彰化縣,263342744,289,0.6668,131571825,15785,0.3332,394914569
2019年02月,南投縣,48407096,91,0.7041,20342037,1094,0.2959,68749133
2019年02月,雲林縣,174667148,90,0.8538,29912463,2335,0.1462,204579611
2019年02月,嘉義縣,33820600,62,0.5222,30950793,1924,0.4778,64771393
2019年02月,屏東縣,47447460,116,0.6371,27026604,1595,0.3629,74474064
2019年02月,台東縣,6864900,3,0.7619,2145750,329,0.2381,9010650
2019年02月,花蓮縣,67460900,15,0.9037,7185852,537,0.0963,74646752
2019年02月,基隆市,7057398,14,0.5204,6503940,358,0.4796,13561338
2019年02月,新竹市,550073584,127,0.9626,21349323,1539,0.0374,571422907
2019年02月,嘉義市,1908176,5,0.3796,3119221,551,0.6204,5027397
2019年02月,澎湖縣,1795600,2,0.5534,1448934,249,0.4466,3244534
2019年02月,金門縣,696600,3,0.369,1190950,275,0.631,1887550
2019年02月,連江縣,0,0,0,540282,57,1,540282
2019年02月,合計,6703798448,3591,0.8486,1196051131,82796,0.1514,7899849579
2019年01月,新北市,206932944,202,0.505474713036405,202450431,14411,0.494525286963595,409383375
2019年01月,台北市,21399100,27,0.521674347669377,19620935,2002,0.478325652330623,41020035
2019年01月,桃園市,1247766669,705,0.838081434064282,241070356,6795,0.161918565935718,1488837025
2019年01月,台中市,1268410073,400,0.843664385065715,235043309,12165,0.156335614934285,1503453382
2019年01月,台南市,1266807078,391,0.868102635538297,192475530,10563,0.131897364461703,1459282608
2019年01月,高雄市,1296828786,535,0.881764534200542,173891271,6014,0.118235465799458,1470720057
2019年01月,宜蘭縣,105244829,59,0.809867832925437,24708263,1185,0.190132167074563,129953092
2019年01月,新竹縣,540162570,210,0.920349884433137,46747451,1699,0.079650115566863,586910021
2019年01月,苗栗縣,341369541,143,0.899263695741674,38240514,1266,0.100736304258326,379610055
2019年01月,彰化縣,319295590,275,0.658278901114843,165750474,15782,0.341721098885157,485046064
2019年01月,南投縣,61080312,87,0.689727351764031,27476872,1093,0.310272648235969,88557184
2019年01月,雲林縣,204616124,88,0.847537307207654,36808203,2322,0.152462692792346,241424327
2019年01月,嘉義縣,45210972,62,0.552916979777762,36557130,1912,0.447083020222238,81768102
2019年01月,屏東縣,59486760,110,0.643332848545338,32979776,1596,0.356667151454662,92466536
2019年01月,台東縣,8423600,3,0.779719950245137,2379766,321,0.220280049754863,10803366
2019年01月,花蓮縣,42251000,14,0.821112696225985,9204787,539,0.178887303774015,51455787
2019年01月,基隆市,7223685,12,0.488996754772056,7548775,357,0.511003245227944,14772460
2019年01月,新竹市,604413675,123,0.960502079564701,24854796,1537,0.0394979204352986,629268471
2019年01月,嘉義市,2379824,4,0.390626887622449,3712496,551,0.609373112377551,6092320
2019年01月,澎湖縣,1824600,2,0.538947254000825,1560889,250,0.461052745999175,3385489
2019年01月,金門縣,872200,3,0.386418210655963,1384940,275,0.613581789344037,2257140
2019年01月,連江縣,0,0,0,588744,57,1,588744
2019年01月,合計,7651999932,3455,0.833818626820486,1525055708,82692,0.166181373179514,9177055640
2018年12月,新北市,221587316,216,0.5096,213232346,14409,0.4904,434819662
2018年12月,台北市,20418900,19,0.5976,13748260,1567,0.4024,34167160
2018年12月,桃園市,1277440906,754,0.8341,254035559,7094,0.1659,1531476465
2018年12月,台中市,1245881254,409,0.8514,217465466,10935,0.1486,1463346720
2018年12月,台南市,1352152792,415,0.8715,199331078,11082,0.1285,1551483870
2018年12月,高雄市,1249975960,524,0.8678,190490010,6331,0.1322,1440465970
2018年12月,宜蘭縣,97639536,59,0.7843,26855284,1389,0.2157,124494820
2018年12月,新竹縣,566723961,230,0.9209,48683141,1504,0.0791,615407102
2018年12月,苗栗縣,347393394,146,0.8979,39520560,1342,0.1021,386913954
2018年12月,彰化縣,323268388,289,0.6571,168713971,15842,0.3429,491982359
2018年12月,南投縣,67701984,95,0.7178,26616225,1134,0.2822,94318209
2018年12月,雲林縣,205413420,92,0.8422,38487804,2535,0.1578,243901224
2018年12月,嘉義縣,45637748,64,0.4638,52762662,2170,0.5362,98400410
2018年12月,屏東縣,63263760,121,0.6221,38431918,1866,0.3779,101695678
2018年12月,台東縣,8110600,3,0.7615,2539741,397,0.2385,10650341
2018年12月,花蓮縣,78674400,17,0.8876,9960822,600,0.1124,88635222
2018年12月,基隆市,8568986,14,0.5263,7712334,384,0.4737,16281320
2018年12月,新竹市,608594040,126,0.9582,26516949,1638,0.0418,635110989
2018年12月,嘉義市,2476640,5,0.3458,4685992,627,0.6542,7162632
2018年12月,澎湖縣,1738100,2,0.4954,1770627,275,0.5046,3508727
2018年12月,金門縣,700000,2,0.3267,1442740,193,0.6733,2142740
2018年12月,連江縣,0,0,0,470767,58,1,470767
2018年12月,合計,7793362085,3602,0.8311,1583474256,83372,0.1689,9376836341
2018年11月,新北市,226764080,217,0.511,216990129,14397,0.489,443754209
2018年11月,台北市,20775600,20,0.6009,13799788,1573,0.3991,34575388
2018年11月,桃園市,1299652207,753,0.8416,244657903,7084,0.1584,1544310110
2018年11月,台中市,1223226468,412,0.8447,224934651,10931,0.1553,1448161119
2018年11月,台南市,1351281584,417,0.8678,205842173,11081,0.1322,1557123757
2018年11月,高雄市,1288560590,519,0.875,184149954,6334,0.125,1472710544
2018年11月,宜蘭縣,95761600,59,0.777,27489693,1390,0.223,123251293
2018年11月,新竹縣,568473260,231,0.9203,49257030,1500,0.0797,617730290
2018年11月,苗栗縣,350838260,152,0.8971,40250805,1344,0.1029,391089065
2018年11月,彰化縣,333399628,288,0.661,170964927,15844,0.339,504364555
2018年11月,南投縣,68893548,95,0.7143,27559259,1134,0.2857,96452807
2018年11月,雲林縣,214714830,91,0.8426,40105450,2532,0.1574,254820280
2018年11月,嘉義縣,46564704,63,0.4525,56334222,2172,0.5475,102898926
2018年11月,屏東縣,62767348,121,0.617,38961025,1857,0.383,101728373
2018年11月,台東縣,8285900,3,0.7753,2401051,393,0.2247,10686951
2018年11月,花蓮縣,75129400,17,0.8833,9925096,597,0.1167,85054496
2018年11月,基隆市,9105289,14,0.5417,7704798,383,0.4583,16810087
2018年11月,新竹市,612876328,126,0.9577,27058810,1641,0.0423,639935138
2018年11月,嘉義市,2309640,5,0.3163,4992911,628,0.6837,7302551
2018年11月,澎湖縣,1657700,2,0.4826,1777057,275,0.5174,3434757
2018年11月,金門縣,1267200,2,0.4532,1529045,192,0.5468,2796245
2018年11月,連江縣,0,0,0,457701,58,1,457701
2018年11月,合計,7862305164,3607,0.8312,1597143478,83340,0.1688,9459448642
2018年10月,新北市,236644300,218,0.5053,231708784,14400,0.4947,468353084
2018年10月,台北市,20744600,19,0.5758,15281570,1569,0.4242,36026170
2018年10月,桃園市,1344736381,757,0.8381,259774500,7080,0.1619,1604510881
2018年10月,台中市,1274980502,411,0.8438,236105296,10938,0.1562,1511085798
2018年10月,台南市,1399629272,415,0.8674,213957200,11085,0.1326,1613586472
2018年10月,高雄市,1317532029,519,0.8686,199238731,6329,0.1314,1516770760
2018年10月,宜蘭縣,102564266,60,0.7813,28703325,1396,0.2187,131267591
2018年10月,新竹縣,594819703,231,0.9193,52223513,1505,0.0807,647043216
2018年10月,苗栗縣,395970900,153,0.9032,42430239,1341,0.0968,438401139
2018年10月,彰化縣,346364240,284,0.6593,178984122,15843,0.3407,525348362
2018年10月,南投縣,73764016,93,0.7198,28721465,1132,0.2802,102485481
2018年10月,雲林縣,226953532,91,0.8458,41368783,2538,0.1542,268322315
2018年10月,嘉義縣,48850008,65,0.4816,52593219,2165,0.5184,101443227
2018年10月,屏東縣,64206000,121,0.6188,39547676,1856,0.3812,103753676
2018年10月,台東縣,8329100,3,0.7738,2434576,392,0.2262,10763676
2018年10月,花蓮縣,76117400,17,0.8813,10253282,595,0.1187,86370682
2018年10月,基隆市,9233200,14,0.5253,8343253,382,0.4747,17576453
2018年10月,新竹市,632708182,125,0.9553,29572492,1634,0.0447,662280674
2018年10月,嘉義市,1917400,4,0.2663,5283725,630,0.7337,7201125
2018年10月,澎湖縣,1754000,2,0.4814,1889452,275,0.5186,3643452
2018年10月,金門縣,1348000,2,0.4482,1659374,190,0.5518,3007374
2018年10月,連江縣,0,0,0,476442,58,1,476442
2018年10月,合計,8179167031,3604,0.8296,1680551019,83333,0.1704,9859718050
2018年09月,新北市,233188172,218,0.4834,249226573,14403,0.5166,482414745
2018年09月,台北市,21115000,20,0.5595,16627143,1571,0.4405,37742143
2018年09月,桃園市,1355127760,756,0.8382,261653657,7080,0.1618,1616781417
2018年09月,台中市,1236963905,408,0.8384,238412334,10933,0.1616,1475376239
2018年09月,台南市,1358072456,412,0.8669,208502472,11073,0.1331,1566574928
2018年09月,高雄市,1257755959,519,0.8832,166413530,6334,0.1168,1424169489
2018年09月,宜蘭縣,94020594,61,0.7581,30005645,1391,0.2419,124026239
2018年09月,新竹縣,601077366,230,0.9161,55076764,1502,0.0839,656154130
2018年09月,苗栗縣,403013494,155,0.9044,42611958,1337,0.0956,445625452
2018年09月,彰化縣,320862692,285,0.6408,179862086,15837,0.3592,500724778
2018年09月,南投縣,70556424,94,0.7194,27514188,1123,0.2806,98070612
2018年09月,雲林縣,219517728,91,0.8437,40656158,2538,0.1563,260173886
2018年09月,嘉義縣,47775404,64,0.5179,44481694,2164,0.4821,92257098
2018年09月,屏東縣,61660399,120,0.6149,38609435,1853,0.3851,100269834
2018年09月,台東縣,8033700,3,0.7702,2396702,392,0.2298,10430402
2018年09月,花蓮縣,69795600,17,0.869,10518739,596,0.131,80314339
2018年09月,基隆市,9552677,14,0.5221,8742642,383,0.4779,18295319
2018年09月,新竹市,637818650,125,0.9528,31562519,1634,0.0472,669381169
2018年09月,嘉義市,1988000,4,0.2744,5256300,631,0.7256,7244300
2018年09月,澎湖縣,1648300,2,0.4369,2124435,274,0.5631,3772735
2018年09月,金門縣,1542400,2,0.463,1788586,190,0.537,3330986
2018年09月,連江縣,0,0,0,539656,58,1,539656
2018年09月,合計,8011086680,3600,0.8281,1662583216,83297,0.1719,9673669896
2018年08月,新北市,254283211,218,0.4908,263776543,14376,0.5092,518059754
2018年08月,台北市,22853200,20,0.5673,17427547,1576,0.4327,40280747
2018年08月,桃園市,1456671522,757,0.8358,286156485,7082,0.1642,1742828007
2018年08月,台中市,1301023612,407,0.8342,258514611,10935,0.1658,1559538223
2018年08月,台南市,1448802757,411,0.8663,223569669,11075,0.1337,1672372426
2018年08月,高雄市,1290772569,518,0.8801,175842131,6343,0.1199,1466614700
2018年08月,宜蘭縣,106905629,61,0.763,33208073,1391,0.237,140113702
2018年08月,新竹縣,611178029,230,0.9123,58720341,1500,0.0877,669898370
2018年08月,苗栗縣,428817158,154,0.9027,46199525,1335,0.0973,475016683
2018年08月,彰化縣,351525043,284,0.6467,192038388,15834,0.3533,543563431
2018年08月,南投縣,76344580,95,0.7239,29123856,1121,0.2761,105468436
2018年08月,雲林縣,224637560,93,0.8376,43555933,2536,0.1624,268193493
2018年08月,嘉義縣,50466608,63,0.5236,45908344,2166,0.4764,96374952
2018年08月,屏東縣,64202200,120,0.6127,40589446,1849,0.3873,104791646
2018年08月,台東縣,8079300,3,0.7533,2646217,394,0.2467,10725517
2018年08月,花蓮縣,62058500,17,0.8404,11788553,597,0.1596,73847053
2018年08月,基隆市,9480698,13,0.5014,9427942,379,0.4986,18908640
2018年08月,新竹市,672669191,125,0.9525,33551882,1631,0.0475,706221073
2018年08月,嘉義市,2145080,4,0.2811,5484809,633,0.7189,7629889
2018年08月,澎湖縣,2205500,2,0.5019,2188973,274,0.4981,4394473
2018年08月,金門縣,1734000,2,0.4611,2026358,189,0.5389,3760358
2018年08月,連江縣,0,0,0,584686,58,1,584686
2018年08月,合計,8446855947,3597,0.8258,1782330312,83274,0.1742,10229186259
2018年07月,新北市,247527148,217,0.4946,252912235,14383,0.5054,500439383
2018年07月,台北市,22897200,20,0.5739,17000505,1577,0.4261,39897705
2018年07月,桃園市,1432428272,756,0.8378,277409152,7075,0.1622,1709837424
2018年07月,台中市,1301991545,405,0.8363,254780178,10933,0.1637,1556771723
2018年07月,台南市,1450219256,409,0.8664,223704125,11078,0.1336,1673923381
2018年07月,高雄市,1134948374,518,0.8648,177498849,6344,0.1352,1312447223
2018年07月,宜蘭縣,101197856,59,0.7619,31629031,1396,0.2381,132826887
2018年07月,新竹縣,638962901,228,0.9167,58044625,1498,0.0833,697007526
2018年07月,苗栗縣,426558059,152,0.9025,46078986,1333,0.0975,472637045
2018年07月,彰化縣,354119045,286,0.6545,186942568,15847,0.3455,541061613
2018年07月,南投縣,74796044,93,0.7203,29044321,1121,0.2797,103840365
2018年07月,雲林縣,223747212,92,0.8367,43679996,2538,0.1633,267427208
2018年07月,嘉義縣,49851368,62,0.5199,46026446,2165,0.4801,95877814
2018年07月,屏東縣,64921376,122,0.6141,40788197,1852,0.3859,105709573
2018年07月,台東縣,8095200,3,0.7538,2643292,389,0.2462,10738492
2018年07月,花蓮縣,75971100,17,0.867,11655158,593,0.133,87626258
2018年07月,基隆市,9378954,13,0.512,8940169,373,0.488,18319123
2018年07月,新竹市,667070209,125,0.9535,32559736,1632,0.0465,699629945
2018年07月,嘉義市,2056320,4,0.277,5365929,631,0.723,7422249
2018年07月,澎湖縣,2398000,2,0.5345,2088836,274,0.4655,4486836
2018年07月,金門縣,1784400,2,0.4509,2172910,193,0.5491,3957310
2018年07月,連江縣,0,0,0,545487,57,1,545487
2018年07月,合計,8290919839,3585,0.8256,1751510731,83282,0.1744,10042430570
2018年06月,新北市,235550981,219,0.4933,241975966,14361,0.5067,477526947
2018年06月,台北市,20648700,19,0.5628,16039159,1580,0.4372,36687859
2018年06月,桃園市,1380210827,756,0.8388,265304418,7074,0.1612,1645515245
2018年06月,台中市,1240081858,405,0.836,243252626,10916,0.164,1483334484
2018年06月,台南市,1391466857,406,0.8659,215413019,11098,0.1341,1606879876
2018年06月,高雄市,1254856447,519,0.8795,171923588,6346,0.1205,1426780035
2018年06月,宜蘭縣,99804112,58,0.7672,30276579,1398,0.2328,130080691
2018年06月,新竹縣,609143830,229,0.917,55138845,1502,0.083,664282675
2018年06月,苗栗縣,410283109,153,0.9028,44180223,1335,0.0972,454463332
2018年06月,彰化縣,338580701,286,0.6532,179785169,15847,0.3468,518365870
2018年06月,南投縣,72748684,94,0.7231,27852279,1117,0.2769,100600963
2018年06月,雲林縣,214951464,91,0.8337,42867405,2536,0.1663,257818869
2018年06月,嘉義縣,46854225,62,0.5321,41205392,2169,0.4679,88059617
2018年06月,屏東縣,61749501,120,0.609,39642478,1852,0.391,101391979
2018年06月,台東縣,7742300,3,0.7687,2329522,390,0.2313,10071822
2018年06月,花蓮縣,69897800,18,0.8602,11363637,593,0.1398,81261437
2018年06月,基隆市,9178128,12,0.5155,8626699,375,0.4845,17804827
2018年06月,新竹市,639399736,125,0.954,30799999,1631,0.046,670199735
2018年06月,嘉義市,2082480,4,0.285,5224072,629,0.715,7306552
2018年06月,澎湖縣,2287100,2,0.5385,1960204,273,0.4615,4247304
2018年06月,金門縣,1611200,2,0.4857,1706227,193,0.5143,3317427
2018年06月,連江縣,0,0,0,474750,58,1,474750
2018年06月,合計,8109130040,3583,0.8286,1677342256,83273,0.1714,9786472296
2018年05月,新北市,247340820,219,0.515,232948819,14350,0.485,480289639
2018年05月,台北市,21335100,20,0.5893,14869468,1589,0.4107,36204568
2018年05月,桃園市,1442872516,755,0.8435,267680368,7072,0.1565,1710552884
2018年05月,台中市,1293725759,403,0.8406,245312972,10919,0.1594,1539038731
2018年05月,台南市,1446251203,408,0.8671,221668622,11109,0.1329,1667919825
2018年05月,高雄市,1336043633,518,0.8797,182750767,6348,0.1203,1518794400
2018年05月,宜蘭縣,98811620,58,0.7647,30403924,1400,0.2353,129215544
2018年05月,新竹縣,627137696,227,0.9211,53755802,1503,0.0789,680893498
2018年05月,苗栗縣,420711308,153,0.9035,44930720,1337,0.0965,465642028
2018年05月,彰化縣,357843048,284,0.664,181098199,15842,0.336,538941247
2018年05月,南投縣,75164212,94,0.7225,28863365,1119,0.2775,104027577
2018年05月,雲林縣,221131712,91,0.8388,42506908,2539,0.1612,263638620
2018年05月,嘉義縣,48528032,61,0.5186,45046252,2159,0.4814,93574284
2018年05月,屏東縣,65584720,119,0.6216,39927173,1850,0.3784,105511893
2018年05月,台東縣,7914000,3,0.7709,2352027,393,0.2291,10266027
2018年05月,花蓮縣,78473600,20,0.8747,11245155,590,0.1253,89718755
2018年05月,基隆市,8290468,12,0.4887,8672391,375,0.5113,16962859
2018年05月,新竹市,650738746,125,0.9552,30552412,1626,0.0448,681291158
2018年05月,嘉義市,2281680,4,0.3101,5076898,631,0.6899,7358578
2018年05月,澎湖縣,2360500,2,0.5517,1918431,273,0.4483,4278931
2018年05月,金門縣,1680400,2,0.5175,1566504,189,0.4825,3246904
2018年05月,連江縣,0,0,0,495026,58,1,495026
2018年05月,合計,8454220773,3578,0.8331,1693642203,83271,0.1669,10147862976
2018年04月,新北市,216942471,216,0.5095,208829358,14346,0.4905,425771829
2018年04月,台北市,18524000,20,0.5805,13387499,1597,0.4195,31911499
2018年04月,桃園市,1315506983,752,0.8491,233718238,7071,0.1509,1549225221
2018年04月,台中市,1186641271,405,0.8468,214716543,10905,0.1532,1401357814
2018年04月,台南市,1334061163,407,0.8727,194659472,11096,0.1273,1528720635
2018年04月,高雄市,1263813995,520,0.878,175554288,6337,0.122,1439368283
2018年04月,宜蘭縣,98611644,58,0.7809,27666588,1400,0.2191,126278232
2018年04月,新竹縣,574084122,225,0.9242,47052683,1502,0.0758,621136805
2018年04月,苗栗縣,402451740,152,0.9113,39180516,1341,0.0887,441632256
2018年04月,彰化縣,323164940,285,0.6639,163582674,15851,0.3361,486747614
2018年04月,南投縣,68342388,94,0.7321,25011010,1120,0.2679,93353398
2018年04月,雲林縣,211089276,90,0.8468,38183187,2539,0.1532,249272463
2018年04月,嘉義縣,42037148,61,0.46,49355562,2158,0.54,91392710
2018年04月,屏東縣,57662878,118,0.6133,36352550,1857,0.3867,94015428
2018年04月,台東縣,8020000,4,0.7828,2225037,394,0.2172,10245037
2018年04月,花蓮縣,73163800,20,0.8778,10182630,590,0.1222,83346430
2018年04月,基隆市,8067562,12,0.5097,7761587,373,0.4903,15829149
2018年04月,新竹市,603374949,125,0.9566,27388111,1626,0.0434,630763060
2018年04月,嘉義市,1960000,4,0.2957,4667897,637,0.7043,6627897
2018年04月,澎湖縣,2154800,2,0.556,1720872,273,0.444,3875672
2018年04月,金門縣,994000,2,0.4192,1377354,189,0.5808,2371354
2018年04月,連江縣,0,0,0,446480,58,1,446480
2018年04月,合計,7810669130,3572,0.8368,1523020136,83260,0.1632,9333689266
2018年03月,新北市,233718968,217,0.539,199877070,14358,0.461,433596038
2018年03月,台北市,19124100,19,0.5978,12867077,1602,0.4022,31991177
2018年03月,桃園市,1367267186,750,0.8448,251117455,7069,0.1552,1618384641
2018年03月,台中市,1210476733,406,0.8463,219856523,10905,0.1537,1430333256
2018年03月,台南市,1380534030,408,0.872,202639902,11113,0.128,1583173932
2018年03月,高雄市,1320801491,520,0.8732,191851854,6326,0.1268,1512653345
2018年03月,宜蘭縣,97480520,58,0.7753,28244218,1396,0.2247,125724738
2018年03月,新竹縣,580171533,227,0.9178,51949925,1503,0.0822,632121458
2018年03月,苗栗縣,419973894,154,0.9148,39135268,1337,0.0852,459109162
2018年03月,彰化縣,334031292,284,0.6704,164197613,15874,0.3296,498228905
2018年03月,南投縣,73929345,94,0.7346,26705948,1118,0.2654,100635293
2018年03月,雲林縣,217770356,90,0.8487,38833333,2543,0.1513,256603689
2018年03月,嘉義縣,43091608,61,0.5369,37163479,2153,0.4631,80255087
2018年03月,屏東縣,59997540,117,0.6232,36270630,1852,0.3768,96268170
2018年03月,台東縣,8354700,4,0.7869,2262995,395,0.2131,10617695
2018年03月,花蓮縣,69666400,20,0.8768,9790770,592,0.1232,79457170
2018年03月,基隆市,8362996,12,0.5152,7868727,374,0.4848,16231723
2018年03月,新竹市,614917951,125,0.9578,27119922,1634,0.0422,642037873
2018年03月,嘉義市,2062920,4,0.3252,4279872,637,0.6748,6342792
2018年03月,澎湖縣,1678400,1,0.4443,2099632,273,0.5557,3778032
2018年03月,金門縣,696400,2,0.3434,1331850,188,0.6566,2028250
2018年03月,連江縣,0,0,0,416580,58,1,416580
2018年03月,合計,8064108363,3573,0.8383,1555880643,83300,0.1617,9619989006
2018年02月,新北市,190616466,218,0.5234,173587489,14354,0.4766,364203955
2018年02月,台北市,15965900,19,0.582,11465148,1602,0.418,27431048
2018年02月,桃園市,1106909874,750,0.8507,194311848,7060,0.1493,1301221722
2018年02月,台中市,1005127635,408,0.8551,170284027,10896,0.1449,1175411662
2018年02月,台南市,1171454728,406,0.8807,158738729,11112,0.1193,1330193457
2018年02月,高雄市,1081630996,523,0.8965,124846759,6321,0.1035,1206477755
2018年02月,宜蘭縣,77354846,61,0.7892,20658672,1396,0.2108,98013518
2018年02月,新竹縣,491596616,225,0.9275,38426004,1508,0.0725,530022620
2018年02月,苗栗縣,329154592,151,0.9149,30614565,1333,0.0851,359769157
2018年02月,彰化縣,249786872,282,0.6481,135632386,15879,0.3519,385419258
2018年02月,南投縣,56838100,95,0.741,19863757,1118,0.259,76701857
2018年02月,雲林縣,179725420,90,0.8525,31100593,2543,0.1475,210826013
2018年02月,嘉義縣,31169008,61,0.5122,29681394,2156,0.4878,60850402
2018年02月,屏東縣,44208644,119,0.6023,29185333,1850,0.3977,73393977
2018年02月,台東縣,6965600,4,0.7876,1878717,394,0.2124,8844317
2018年02月,花蓮縣,65192700,20,0.8694,9791314,592,0.1306,74984014
2018年02月,基隆市,6204485,12,0.4962,6300013,373,0.5038,12504498
2018年02月,新竹市,601276554,125,0.9641,22378209,1641,0.0359,623654763
2018年02月,嘉義市,1584760,4,0.2931,3821413,636,0.7069,5406173
2018年02月,澎湖縣,1419600,1,0.4342,1849784,274,0.5658,3269384
2018年02月,金門縣,460000,2,0.2933,1108323,186,0.7067,1568323
2018年02月,連江縣,0,0,0,381275,58,1,381275
2018年02月,合計,6714643396,3576,0.8467,1215905752,83282,0.1533,7930549148
2018年01月,新北市,245429644,219,0.5388,210067856,14379,0.4612,455497500
2018年01月,台北市,19488900,19,0.5925,13405944,1615,0.4075,32894844
2018年01月,桃園市,1358177898,745,0.8417,255360214,7067,0.1583,1613538112
2018年01月,台中市,1177546085,408,0.8429,219508597,10896,0.1571,1397054682
2018年01月,台南市,1352884532,407,0.8706,201172447,11117,0.1294,1554056979
2018年01月,高雄市,1264408247,524,0.8897,156771661,6331,0.1103,1421179908
2018年01月,宜蘭縣,106626599,60,0.7975,27067139,1398,0.2025,133693738
2018年01月,新竹縣,572936500,226,0.9238,47262402,1509,0.0762,620198902
2018年01月,苗栗縣,401147528,152,0.9093,40021688,1337,0.0907,441169216
2018年01月,彰化縣,325550216,282,0.6573,169709871,15896,0.3427,495260087
2018年01月,南投縣,71954728,95,0.7343,26030949,1121,0.2657,97985677
2018年01月,雲林縣,209494391,90,0.8472,37790881,2538,0.1528,247285272
2018年01月,嘉義縣,41542896,60,0.5201,38335395,2150,0.4799,79878291
2018年01月,屏東縣,56857668,119,0.6124,35991746,1850,0.3876,92849414
2018年01月,台東縣,7768100,4,0.7842,2137804,395,0.2158,9905904
2018年01月,花蓮縣,78946200,20,0.8808,10688686,590,0.1192,89634886
2018年01月,基隆市,8331974,12,0.5168,7789825,376,0.4832,16121799
2018年01月,新竹市,595913863,125,0.9569,26862483,1645,0.0431,622776346
2018年01月,嘉義市,2240040,4,0.335,4446654,637,0.665,6686694
2018年01月,澎湖縣,1576400,1,0.4386,2017580,275,0.5614,3593980
2018年01月,金門縣,650000,2,0.3298,1321144,185,0.6702,1971144
2018年01月,連江縣,0,0,0,441206,59,1,441206
2018年01月,合計,7899472409,3574,0.8374,1534202172,83366,0.1626,9433674581
2017年12月,新北市,225305536,221,0.5093,217097567,14382,0.4907,442403103
2017年12月,台北市,20466300,20,0.5939,13993907,1608,0.4061,34460207
2017年12月,桃園市,1354510278,739,0.8485,241867145,7070,0.1515,1596377423
2017年12月,台中市,1163238844,408,0.8413,219439760,10904,0.1587,1382678604
2017年12月,台南市,1347752727,410,0.8698,201729075,11114,0.1302,1549481802
2017年12月,高雄市,1278048749,524,0.8886,160181982,6324,0.1114,1438230731
2017年12月,宜蘭縣,101900115,60,0.7936,26507032,1398,0.2064,128407147
2017年12月,新竹縣,569460357,226,0.9229,47571803,1505,0.0771,617032160
2017年12月,苗栗縣,395005767,149,0.9091,39500882,1334,0.0909,434506649
2017年12月,彰化縣,324441744,280,0.6568,169515885,15908,0.3432,493957629
2017年12月,南投縣,69017384,95,0.7277,25827514,1118,0.2723,94844898
2017年12月,雲林縣,211102980,91,0.8451,38685451,2533,0.1549,249788431
2017年12月,嘉義縣,40934828,58,0.434,53387105,2146,0.566,94321933
2017年12月,屏東縣,55631440,118,0.6006,36999457,1852,0.3994,92630897
2017年12月,台東縣,8343300,4,0.802,2060463,394,0.198,10403763
2017年12月,花蓮縣,80631300,20,0.8832,10665812,592,0.1168,91297112
2017年12月,基隆市,8405659,12,0.5137,7956989,376,0.4863,16362648
2017年12月,新竹市,596884798,124,0.9564,27238315,1649,0.0436,624123113
2017年12月,嘉義市,1885200,4,0.2846,4737731,638,0.7154,6622931
2017年12月,澎湖縣,1342400,1,0.404,1980130,275,0.596,3322530
2017年12月,金門縣,726800,2,0.3483,1360077,184,0.6517,2086877
2017年12月,連江縣,0,0,0,433485,59,1,433485
2017年12月,合計,7855036506,3566,0.8353,1548737567,83363,0.1647,9403774073
2017年11月,新北市,227343990,222,0.5051,222746496,14377,0.4949,450090486
2017年11月,台北市,19889800,19,0.5723,14863148,1605,0.4277,34752948
2017年11月,桃園市,1345102062,741,0.845,246669135,7063,0.155,1591771197
2017年11月,台中市,1183746454,407,0.8407,224352382,10911,0.1593,1408098836
2017年11月,台南市,1339513945,413,0.8658,207540496,11105,0.1342,1547054441
2017年11月,高雄市,1269769262,524,0.8807,171981620,6315,0.1193,1441750882
2017年11月,宜蘭縣,93259578,63,0.7727,27431625,1396,0.2273,120691203
2017年11月,新竹縣,580112716,226,0.9203,50218826,1507,0.0797,630331542
2017年11月,苗栗縣,429796386,152,0.9128,41033952,1339,0.0872,470830338
2017年11月,彰化縣,331858464,278,0.6596,171282546,15915,0.3404,503141010
2017年11月,南投縣,66554484,94,0.7099,27195411,1123,0.2901,93749895
2017年11月,雲林縣,207103400,91,0.8386,39852564,2536,0.1614,246955964
2017年11月,嘉義縣,41280948,56,0.5097,39717131,2141,0.4903,80998079
2017年11月,屏東縣,59327620,119,0.6098,37967728,1849,0.3902,97295348
2017年11月,台東縣,8090000,4,0.7899,2152283,395,0.2101,10242283
2017年11月,花蓮縣,76045300,20,0.881,10276278,593,0.119,86321578
2017年11月,基隆市,8600192,12,0.5157,8076711,377,0.4843,16676903
2017年11月,新竹市,601540648,123,0.9547,28565091,1652,0.0453,630105739
2017年11月,嘉義市,1989920,4,0.2857,4974866,638,0.7143,6964786
2017年11月,澎湖縣,1267600,1,0.3833,2039431,275,0.6167,3307031
2017年11月,金門縣,1307200,2,0.4816,1407062,181,0.5184,2714262
2017年11月,連江縣,0,0,0,459970,59,1,459970
2017年11月,合計,7893499969,3571,0.8331,1580804752,83352,0.1669,9474304721
2017年10月,新北市,233855931,222,0.489,244382400,14377,0.511,478238331
2017年10月,台北市,20808700,18,0.5451,17364985,1608,0.4549,38173685
2017年10月,桃園市,1409352792,740,0.8465,255650492,7059,0.1535,1665003284
2017年10月,台中市,1210681686,406,0.8382,233651672,10922,0.1618,1444333358
2017年10月,台南市,1403356963,414,0.8698,210049272,11111,0.1302,1613406235
2017年10月,高雄市,1279239767,525,0.8775,178515796,6319,0.1225,1457755563
2017年10月,宜蘭縣,101967997,62,0.7762,29403647,1398,0.2238,131371644
2017年10月,新竹縣,617491275,227,0.9207,53171922,1507,0.0793,670663197
2017年10月,苗栗縣,409290881,151,0.9056,42650123,1339,0.0944,451941004
2017年10月,彰化縣,335669828,280,0.6504,180454194,15925,0.3496,516124022
2017年10月,南投縣,71466626,92,0.7185,28000624,1125,0.2815,99467250
2017年10月,雲林縣,222342232,90,0.8444,40985892,2538,0.1556,263328124
2017年10月,嘉義縣,41700588,56,0.4691,47195224,2140,0.5309,88895812
2017年10月,屏東縣,57363020,119,0.5968,38760411,1849,0.4032,96123431
2017年10月,台東縣,8131200,4,0.7864,2208602,395,0.2136,10339802
2017年10月,花蓮縣,75811300,20,0.8749,10838765,594,0.1251,86650065
2017年10月,基隆市,10201400,12,0.5462,8474218,379,0.4538,18675618
2017年10月,新竹市,633428988,123,0.9505,33009381,1651,0.0495,666438369
2017年10月,嘉義市,1925840,4,0.2568,5573297,639,0.7432,7499137
2017年10月,澎湖縣,1291600,1,0.3589,2307029,275,0.6411,3598629
2017年10月,金門縣,1455600,2,0.4668,1662888,181,0.5332,3118488
2017年10月,連江縣,0,0,0,538242,59,1,538242
2017年10月,合計,8146834214,3568,0.8303,1664849076,83390,0.1697,9811683290
2017年09月,新北市,240875479,221,0.4893,251453537,14378,0.5107,492329016
2017年09月,台北市,21233100,18,0.5433,17847230,1613,0.4567,39080330
2017年09月,桃園市,1425914927,739,0.8406,270490017,7061,0.1594,1696404944
2017年09月,台中市,1153083704,404,0.8252,244221726,10921,0.1748,1397305430
2017年09月,台南市,1417699780,415,0.8672,217093743,11111,0.1328,1634793523
2017年09月,高雄市,1240700811,524,0.8759,175745943,6305,0.1241,1416446754
2017年09月,宜蘭縣,103754616,62,0.7706,30890434,1393,0.2294,134645050
2017年09月,新竹縣,624006364,225,0.9176,56049736,1511,0.0824,680056100
2017年09月,苗栗縣,403409784,148,0.9015,44064196,1340,0.0985,447473980
2017年09月,彰化縣,337511400,278,0.6469,184262065,15928,0.3531,521773465
2017年09月,南投縣,72853464,92,0.7166,28814711,1121,0.2834,101668175
2017年09月,雲林縣,218100960,88,0.8376,42280036,2534,0.1624,260380996
2017年09月,嘉義縣,42740508,57,0.5093,41178358,2137,0.4907,83918866
2017年09月,屏東縣,59391047,119,0.607,38456690,1847,0.393,97847737
2017年09月,台東縣,8001000,4,0.7847,2195176,393,0.2153,10196176
2017年09月,花蓮縣,78217000,21,0.8803,10638364,592,0.1197,88855364
2017年09月,基隆市,10390489,12,0.5403,8842016,377,0.4597,19232505
2017年09月,新竹市,642831969,122,0.9511,33052562,1654,0.0489,675884531
2017年09月,嘉義市,2047320,4,0.2713,5498546,640,0.7287,7545866
2017年09月,澎湖縣,1253600,1,0.3468,2361528,275,0.6532,3615128
2017年09月,金門縣,1739200,2,0.5015,1728953,181,0.4985,3468153
2017年09月,連江縣,0,0,0,560609,60,1,560609
2017年09月,合計,8105756522,3556,0.826,1707726176,83372,0.174,9813482698
2017年08月,新北市,197672975,221,0.4343,257524247,14379,0.5657,455197222
2017年08月,台北市,21958500,18,0.5429,18488278,1617,0.4571,40446778
2017年08月,桃園市,1456940357,740,0.8373,283204634,7064,0.1627,1740144991
2017年08月,台中市,1201922402,401,0.8256,253896785,10925,0.1744,1455819187
2017年08月,台南市,1460372474,415,0.8681,221829832,11114,0.1319,1682202306
2017年08月,高雄市,1167691444,523,0.8703,174094073,6295,0.1297,1341785517
2017年08月,宜蘭縣,105824536,62,0.7661,32313294,1398,0.2339,138137830
2017年08月,新竹縣,635870057,221,0.9158,58447968,1512,0.0842,694318025
2017年08月,苗栗縣,353873938,143,0.881,47813081,1343,0.119,401687019
2017年08月,彰化縣,348856444,278,0.6484,189174126,15926,0.3516,538030570
2017年08月,南投縣,74585215,93,0.7137,29915491,1123,0.2863,104500706
2017年08月,雲林縣,223670828,87,0.8361,43839707,2535,0.1639,267510535
2017年08月,嘉義縣,44351079,55,0.5112,42408480,2138,0.4888,86759559
2017年08月,屏東縣,59350572,119,0.604,38908317,1845,0.396,98258889
2017年08月,台東縣,7922400,4,0.7751,2299265,392,0.2249,10221665
2017年08月,花蓮縣,62561163,21,0.8374,12146159,595,0.1626,74707322
2017年08月,基隆市,10349100,12,0.5297,9189497,378,0.4703,19538597
2017年08月,新竹市,664607972,122,0.9519,33609309,1657,0.0481,698217281
2017年08月,嘉義市,1987720,4,0.2623,5591518,640,0.7377,7579238
2017年08月,澎湖縣,1289600,1,0.3443,2455599,277,0.6557,3745199
2017年08月,金門縣,1811600,2,0.5073,1759139,180,0.4927,3570739
2017年08月,連江縣,0,0,0,614072,59,1,614072
2017年08月,合計,8103470376,3542,0.8216,1759522871,83392,0.1784,9862993247
2017年07月,新北市,241763974,221,0.4914,250258336,14391,0.5086,492022310
2017年07月,台北市,21212500,19,0.5443,17756861,1606,0.4557,38969361
2017年07月,桃園市,1437856562,742,0.841,271776546,7066,0.159,1709633108
2017年07月,台中市,1162375158,398,0.8235,249117418,10936,0.1765,1411492576
2017年07月,台南市,1439043850,414,0.8684,218050309,11111,0.1316,1657094159
2017年07月,高雄市,1280630691,524,0.8821,171210898,6298,0.1179,1451841589
2017年07月,宜蘭縣,93041896,63,0.748,31337949,1392,0.252,124379845
2017年07月,新竹縣,631688929,222,0.9171,57081713,1511,0.0829,688770642
2017年07月,苗栗縣,394791753,147,0.8966,45534187,1346,0.1034,440325940
2017年07月,彰化縣,341732000,277,0.6473,186214570,15928,0.3527,527946570
2017年07月,南投縣,73655612,93,0.7225,28283711,1123,0.2775,101939323
2017年07月,雲林縣,218549254,86,0.8351,43170547,2537,0.1649,261719801
2017年07月,嘉義縣,41869250,55,0.5009,41724001,2136,0.4991,83593251
2017年07月,屏東縣,58970372,118,0.6068,38206229,1843,0.3932,97176601
2017年07月,台東縣,8460500,3,0.7589,2688381,394,0.2411,11148881
2017年07月,花蓮縣,80358900,21,0.8765,11323360,595,0.1235,91682260
2017年07月,基隆市,9937787,12,0.5187,9222386,375,0.4813,19160173
2017年07月,新竹市,658136993,122,0.9514,33628265,1653,0.0486,691765258
2017年07月,嘉義市,2162280,4,0.2861,5394514,640,0.7139,7556794
2017年07月,澎湖縣,1287200,1,0.3384,2516425,277,0.6616,3803625
2017年07月,金門縣,1777600,2,0.5099,1708599,180,0.4901,3486199
2017年07月,連江縣,0,0,0,624477,59,1,624477
2017年07月,合計,8199303061,3544,0.8269,1716829682,83397,0.1731,9916132743
2017年06月,新北市,234049268,220,0.5001,233944549,14388,0.4999,467993817
2017年06月,台北市,20262600,19,0.5576,16077305,1615,0.4424,36339905
2017年06月,桃園市,1393351097,742,0.8421,261328901,7066,0.1579,1654679998
2017年06月,台中市,1149127125,395,0.8269,240569229,10946,0.1731,1389696354
2017年06月,台南市,1405846447,416,0.8667,216271507,11115,0.1333,1622117954
2017年06月,高雄市,1080592282,519,0.8647,169104095,6304,0.1353,1249696377
2017年06月,宜蘭縣,85869642,63,0.7458,29266933,1393,0.2542,115136575
2017年06月,新竹縣,590761017,219,0.915,54881860,1509,0.085,645642877
2017年06月,苗栗縣,367212250,144,0.8949,43107285,1339,0.1051,410319535
2017年06月,彰化縣,290856940,276,0.6119,184506407,15928,0.3881,475363347
2017年06月,南投縣,71502660,93,0.7183,28047931,1123,0.2817,99550591
2017年06月,雲林縣,210974642,88,0.8367,41180969,2531,0.1633,252155611
2017年06月,嘉義縣,40783918,56,0.5073,39615241,2137,0.4927,80399159
2017年06月,屏東縣,59532548,118,0.6118,37773243,1842,0.3882,97305791
2017年06月,台東縣,8117000,3,0.7704,2418447,392,0.2296,10535447
2017年06月,花蓮縣,70440480,22,0.8676,10747371,595,0.1324,81187851
2017年06月,基隆市,10106844,12,0.5359,8752424,375,0.4641,18859268
2017年06月,新竹市,596258841,120,0.9513,30517162,1655,0.0487,626776003
2017年06月,嘉義市,2026200,4,0.2779,5263758,641,0.7221,7289958
2017年06月,澎湖縣,1271600,1,0.3634,2227209,277,0.6366,3498809
2017年06月,金門縣,1628400,2,0.5135,1542886,179,0.4865,3171286
2017年06月,連江縣,0,0,0,551535,59,1,551535
2017年06月,合計,7690571801,3532,0.8227,1657696247,83409,0.1773,9348268048
2017年05月,新北市,241518036,219,0.5198,223084010,14382,0.4802,464602046
2017年05月,台北市,20459200,18,0.5797,14835132,1615,0.4203,35294332
2017年05月,桃園市,1376313443,743,0.8465,249479317,7041,0.1535,1625792760
2017年05月,台中市,1174440419,392,0.8369,228842271,10940,0.1631,1403282690
2017年05月,台南市,1420413209,420,0.8731,206432525,11107,0.1269,1626845734
2017年05月,高雄市,1277504540,520,0.887,162725501,6320,0.113,1440230041
2017年05月,宜蘭縣,91794139,63,0.7656,28108885,1395,0.2344,119903024
2017年05月,新竹縣,510985526,216,0.9078,51926421,1500,0.0922,562911947
2017年05月,苗栗縣,402043819,145,0.9028,43263967,1342,0.0972,445307786
2017年05月,彰化縣,325794565,274,0.6446,179632226,15935,0.3554,505426791
2017年05月,南投縣,70921298,93,0.7232,27147605,1126,0.2768,98068903
2017年05月,雲林縣,212717696,88,0.8419,39951474,2528,0.1581,252669170
2017年05月,嘉義縣,40995620,55,0.5173,38249091,2142,0.4827,79244711
2017年05月,屏東縣,60682328,117,0.6212,37000318,1845,0.3788,97682646
2017年05月,台東縣,8678800,3,0.792,2279196,391,0.208,10957996
2017年05月,花蓮縣,82266028,21,0.8822,10990208,596,0.1178,93256236
2017年05月,基隆市,9162400,11,0.5097,8812350,378,0.4903,17974750
2017年05月,新竹市,587482663,119,0.9537,28537274,1658,0.0463,616019937
2017年05月,嘉義市,1845960,4,0.2663,5085270,639,0.7337,6931230
2017年05月,澎湖縣,1323200,1,0.3842,2121095,277,0.6158,3444295
2017年05月,金門縣,1526000,2,0.511,1460110,178,0.489,2986110
2017年05月,連江縣,0,0,0,475825,59,1,475825
2017年05月,合計,7918868889,3524,0.8327,1590440071,83394,0.1673,9509308960
2017年04月,新北市,215616373,219,0.5059,210615992,14388,0.4941,426232365
2017年04月,台北市,19724900,20,0.59,13704789,1619,0.41,33429689
2017年04月,桃園市,1295507190,750,0.8466,234701448,7025,0.1534,1530208638
2017年04月,台中市,1095012523,393,0.8366,213862426,10932,0.1634,1308874949
2017年04月,台南市,1332436276,422,0.8704,198362599,11118,0.1296,1530798875
2017年04月,高雄市,1252775537,516,0.8915,152439222,6324,0.1085,1405214759
2017年04月,宜蘭縣,102613712,63,0.7992,25786424,1397,0.2008,128400136
2017年04月,新竹縣,546764929,222,0.919,48182768,1501,0.081,594947697
2017年04月,苗栗縣,370686460,141,0.9025,40028397,1346,0.0975,410714857
2017年04月,彰化縣,295919764,274,0.6294,174207715,15942,0.3706,470127479
2017年04月,南投縣,66698477,93,0.7216,25733008,1123,0.2784,92431485
2017年04月,雲林縣,198570136,87,0.84,37820400,2532,0.16,236390536
2017年04月,嘉義縣,38800168,56,0.4798,42060519,2141,0.5202,80860687
2017年04月,屏東縣,56063503,117,0.6206,34277349,1843,0.3794,90340852
2017年04月,台東縣,8368800,3,0.7879,2252776,390,0.2121,10621576
2017年04月,花蓮縣,75355000,21,0.8752,10749756,595,0.1248,86104756
2017年04月,基隆市,8711100,11,0.5172,8132541,377,0.4828,16843641
2017年04月,新竹市,597425116,122,0.9569,26921617,1654,0.0431,624346733
2017年04月,嘉義市,1872520,4,0.2839,4722359,641,0.7161,6594879
2017年04月,澎湖縣,1270400,1,0.3871,2011586,275,0.6129,3281986
2017年04月,金門縣,914000,2,0.4021,1359085,179,0.5979,2273085
2017年04月,連江縣,0,0,0,425502,59,1,425502
2017年04月,合計,7581106884,3537,0.8341,1508358278,83401,0.1659,9089465162
2017年03月,新北市,216938468,218,0.5165,203049835,14398,0.4835,419988303
2017年03月,台北市,19862500,20,0.6113,12627131,1627,0.3887,32489631
2017年03月,桃園市,1336371313,754,0.8427,249457489,7013,0.1573,1585828802
2017年03月,台中市,1107724112,390,0.8351,218774580,10936,0.1649,1326498692
2017年03月,台南市,1379694864,421,0.8737,199430775,11132,0.1263,1579125639
2017年03月,高雄市,1288092685,517,0.8931,154122216,6325,0.1069,1442214901
2017年03月,宜蘭縣,105211300,63,0.8022,25937386,1393,0.1978,131148686
2017年03月,新竹縣,549623805,222,0.9212,46996027,1496,0.0788,596619832
2017年03月,苗栗縣,419754424,145,0.9097,41648362,1350,0.0903,461402786
2017年03月,彰化縣,327841730,273,0.6527,174443548,15946,0.3473,502285278
2017年03月,南投縣,71739680,93,0.7275,26865181,1121,0.2725,98604861
2017年03月,雲林縣,205192700,89,0.845,37629881,2529,0.155,242822581
2017年03月,嘉義縣,40440536,56,0.5064,39410938,2140,0.4936,79851474
2017年03月,屏東縣,58323452,116,0.6274,34634318,1849,0.3726,92957770
2017年03月,台東縣,8522800,4,0.816,1921670,390,0.184,10444470
2017年03月,花蓮縣,79301300,21,0.877,11121427,592,0.123,90422727
2017年03月,基隆市,9749400,12,0.5745,7221529,376,0.4255,16970929
2017年03月,新竹市,605224922,123,0.9608,24662513,1659,0.0392,629887435
2017年03月,嘉義市,2090400,4,0.3236,4369028,642,0.6764,6459428
2017年03月,澎湖縣,1322800,1,0.4137,1874722,275,0.5863,3197522
2017年03月,金門縣,639600,2,0.336,1263797,180,0.664,1903397
2017年03月,連江縣,0,0,0,425585,60,1,425585
2017年03月,合計,7833662791,3544,0.8377,1517887938,83429,0.1623,9351550729
2017年02月,新北市,178462707,223,0.4978,180015410,14418,0.5022,358478117
2017年02月,台北市,17789100,20,0.5902,12351876,1640,0.4098,30140976
2017年02月,桃園市,1180274404,757,0.8553,199675058,7004,0.1447,1379949462
2017年02月,台中市,941622250,389,0.8371,183264832,10941,0.1629,1124887082
2017年02月,台南市,1206988847,424,0.8751,172279239,11122,0.1249,1379268086
2017年02月,高雄市,1136567889,517,0.8973,130142049,6320,0.1027,1266709938
2017年02月,宜蘭縣,90710536,63,0.7972,23075854,1393,0.2028,113786390
2017年02月,新竹縣,487266982,223,0.9214,41546918,1497,0.0786,528813900
2017年02月,苗栗縣,351745678,145,0.9104,34612422,1350,0.0896,386358100
2017年02月,彰化縣,267833249,273,0.6374,152332219,15944,0.3626,420165468
2017年02月,南投縣,59957000,93,0.7212,23174605,1121,0.2788,83131605
2017年02月,雲林縣,185683276,88,0.8496,32858939,2530,0.1504,218542215
2017年02月,嘉義縣,32672364,56,0.4689,37001535,2137,0.5311,69673899
2017年02月,屏東縣,48110802,116,0.6119,30510923,1844,0.3881,78621725
2017年02月,台東縣,7496700,4,0.8003,1870151,386,0.1997,9366851
2017年02月,花蓮縣,64883000,21,0.871,9611399,593,0.129,74494399
2017年02月,基隆市,8382900,12,0.5659,6429691,376,0.4341,14812591
2017年02月,新竹市,542107756,123,0.961,21972699,1659,0.039,564080455
2017年02月,嘉義市,1784120,4,0.3001,4161602,643,0.6999,5945722
2017年02月,澎湖縣,1197600,1,0.4008,1790199,274,0.5992,2987799
2017年02月,金門縣,540400,2,0.3314,1090423,180,0.6686,1630823
2017年02月,連江縣,0,0,0,404155,60,1,404155
2017年02月,合計,6812077560,3554,0.8397,1300172198,83432,0.1603,8112249758
2017年01月,新北市,193619706,223,0.496,196760890,14426,0.504,390380596
2017年01月,台北市,20010800,21,0.6002,13330201,1623,0.3998,33341001
2017年01月,桃園市,1219555084,757,0.8532,209879192,7001,0.1468,1429434276
2017年01月,台中市,1012270708,388,0.8393,193882892,10941,0.1607,1206153600
2017年01月,台南市,1303663692,426,0.8821,174228550,11118,0.1179,1477892242
2017年01月,高雄市,1196156917,517,0.8963,138419325,6322,0.1037,1334576242
2017年01月,宜蘭縣,95552077,63,0.7965,24405423,1396,0.2035,119957500
2017年01月,新竹縣,524502878,222,0.9217,44538161,1494,0.0783,569041039
2017年01月,苗栗縣,370491214,145,0.9093,36963626,1350,0.0907,407454840
2017年01月,彰化縣,273285086,272,0.6218,166231292,15940,0.3782,439516378
2017年01月,南投縣,60897271,94,0.722,23450565,1119,0.278,84347836
2017年01月,雲林縣,197543076,88,0.8519,34339799,2526,0.1481,231882875
2017年01月,嘉義縣,33361464,56,0.4875,35075938,2131,0.5125,68437402
2017年01月,屏東縣,50368616,117,0.6076,32531984,1844,0.3924,82900600
2017年01月,台東縣,7720600,3,0.7831,2138789,381,0.2169,9859389
2017年01月,花蓮縣,73474700,21,0.8759,10413313,595,0.1241,83888013
2017年01月,基隆市,9379500,12,0.5773,6867162,376,0.4227,16246662
2017年01月,新竹市,605875905,124,0.9629,23373421,1665,0.0371,629249326
2017年01月,嘉義市,1658960,4,0.2685,4519679,646,0.7315,6178639
2017年01月,澎湖縣,1288400,1,0.4057,1887293,274,0.5943,3175693
2017年01月,金門縣,550000,2,0.3009,1278116,179,0.6991,1828116
2017年01月,連江縣,0,0,0,458511,60,1,458511
2017年01月,合計,7251226654,3556,0.8406,1374974122,83407,0.1594,8626200776
2016年12月,新北市,213541778,222,0.4876,224369917,14444,0.5124,437911695
2016年12月,台北市,20390700,22,0.5808,14718958,1625,0.4192,35109658
2016年12月,桃園市,1330061779,761,0.8406,252184506,7019,0.1594,1582246285
2016年12月,台中市,1044282975,389,0.8222,225748752,10928,0.1778,1270031727
2016年12月,台南市,1397658912,428,0.874,201460758,11117,0.126,1599119670
2016年12月,高雄市,1240502846,519,0.8866,158735057,6309,0.1134,1399237903
2016年12月,宜蘭縣,110853097,65,0.7933,28886131,1397,0.2067,139739228
2016年12月,新竹縣,551677651,220,0.9161,50543503,1496,0.0839,602221154
2016年12月,苗栗縣,392846442,147,0.9027,42365041,1344,0.0973,435211483
2016年12月,彰化縣,308651680,272,0.6277,183093462,15949,0.3723,491745142
2016年12月,南投縣,70724220,93,0.7209,27378731,1120,0.2791,98102951
2016年12月,雲林縣,212130277,89,0.8458,38687821,2522,0.1542,250818098
2016年12月,嘉義縣,38813008,56,0.5028,38386861,2130,0.4972,77199869
2016年12月,屏東縣,58039508,118,0.6157,36232865,1852,0.3843,94272373
2016年12月,台東縣,7276600,3,0.7566,2340804,380,0.2434,9617404
2016年12月,花蓮縣,86898700,21,0.8803,11815625,595,0.1197,98714325
2016年12月,基隆市,9230600,12,0.5363,7979881,377,0.4637,17210481
2016年12月,新竹市,615600356,124,0.9595,25964792,1669,0.0405,641565148
2016年12月,嘉義市,2076680,4,0.2891,5106710,646,0.7109,7183390
2016年12月,澎湖縣,1290400,1,0.3959,1969386,274,0.6041,3259786
2016年12月,金門縣,793600,2,0.3753,1320980,178,0.6247,2114580
2016年12月,連江縣,0,0,0,428143,60,1,428143
2016年12月,合計,7713341809,3568,0.83,1579718684,83431,0.17,9293060493
2016年11月,新北市,210380411,221,0.4768,230851566,14462,0.5232,441231977
2016年11月,台北市,20616800,22,0.5677,15696434,1628,0.4323,36313234
2016年11月,桃園市,1314358917,761,0.8428,245239948,7004,0.1572,1559598865
2016年11月,台中市,1024251353,391,0.818,227899835,10932,0.182,1252151188
2016年11月,台南市,1375505852,429,0.8703,205025311,11117,0.1297,1580531163
2016年11月,高雄市,1284668966,516,0.8839,168671118,6313,0.1161,1453340084
2016年11月,宜蘭縣,105757828,65,0.774,30877630,1396,0.226,136635458
2016年11月,新竹縣,546225135,219,0.9131,51997079,1507,0.0869,598222214
2016年11月,苗栗縣,373893765,148,0.8992,41895117,1342,0.1008,415788882
2016年11月,彰化縣,304751236,273,0.6229,184508381,15961,0.3771,489259617
2016年11月,南投縣,66594120,93,0.7103,27161353,1123,0.2897,93755473
2016年11月,雲林縣,209345364,89,0.8407,39673505,2521,0.1593,249018869
2016年11月,嘉義縣,38485740,56,0.434,50184942,2127,0.566,88670682
2016年11月,屏東縣,56808996,119,0.6099,36341747,1850,0.3901,93150743
2016年11月,台東縣,7955800,3,0.769,2390466,381,0.231,10346266
2016年11月,花蓮縣,76354200,21,0.8728,11131023,594,0.1272,87485223
2016年11月,基隆市,9844100,12,0.5491,8084624,377,0.4509,17928724
2016年11月,新竹市,614443344,124,0.9566,27892873,1668,0.0434,642336217
2016年11月,嘉義市,1896400,4,0.2673,5199411,646,0.7327,7095811
2016年11月,澎湖縣,1245600,1,0.3755,2071655,274,0.6245,3317255
2016年11月,金門縣,1320000,2,0.4851,1400982,179,0.5149,2720982
2016年11月,連江縣,0,0,0,394279,59,1,394279
2016年11月,合計,7644703927,3569,0.8256,1614589279,83461,0.1744,9259293206
2016年10月,新北市,224640793,221,0.4863,237323905,14471,0.5137,461964698
2016年10月,台北市,21650500,22,0.562,16873433,1629,0.438,38523933
2016年10月,桃園市,1378300789,761,0.8454,251965740,7008,0.1546,1630266529
2016年10月,台中市,1068051748,387,0.8233,229194473,10937,0.1767,1297246221
2016年10月,台南市,1445397885,431,0.8791,198776904,11116,0.1209,1644174789
2016年10月,高雄市,1290392363,520,0.8824,172055452,6307,0.1176,1462447815
2016年10月,宜蘭縣,107528825,65,0.7886,28828433,1396,0.2114,136357258
2016年10月,新竹縣,583585669,221,0.9145,54534356,1503,0.0855,638120025
2016年10月,苗栗縣,396653124,149,0.9026,42803976,1339,0.0974,439457100
2016年10月,彰化縣,315112240,273,0.6342,181714970,15970,0.3658,496827210
2016年10月,南投縣,70314100,93,0.7184,27566247,1121,0.2816,97880347
2016年10月,雲林縣,221479096,89,0.847,40015061,2525,0.153,261494157
2016年10月,嘉義縣,39369448,57,0.4375,50611194,2124,0.5625,89980642
2016年10月,屏東縣,56897886,119,0.6117,36114520,1847,0.3883,93012406
2016年10月,台東縣,8025700,3,0.7777,2293900,381,0.2223,10319600
2016年10月,花蓮縣,77874500,20,0.8727,11364185,599,0.1273,89238685
2016年10月,基隆市,10059800,12,0.5434,8454504,375,0.4566,18514304
2016年10月,新竹市,659758604,123,0.9559,30419470,1672,0.0441,690178074
2016年10月,嘉義市,1854480,4,0.2576,5344313,647,0.7424,7198793
2016年10月,澎湖縣,1251600,1,0.3623,2203432,274,0.6377,3455032
2016年10月,金門縣,1524800,2,0.4965,1545997,179,0.5035,3070797
2016年10月,連江縣,0,0,0,464681,59,1,464681
2016年10月,合計,7979723950,3573,0.8303,1630469146,83479,0.1697,9610193096
2016年09月,新北市,209795403,222,0.458,248255931,14488,0.542,458051334
2016年09月,台北市,20340500,22,0.5308,17979516,1642,0.4692,38320016
2016年09月,桃園市,1332871836,761,0.8406,252729160,7011,0.1594,1585600996
2016年09月,台中市,983013748,387,0.8117,228066144,10948,0.1883,1211079892
2016年09月,台南市,1384179191,427,0.8756,196587290,11125,0.1244,1580766481
2016年09月,高雄市,1112068836,521,0.8787,153573869,6307,0.1213,1265642705
2016年09月,宜蘭縣,91931996,64,0.7622,28681691,1399,0.2378,120613687
2016年09月,新竹縣,562740823,222,0.9134,53351155,1506,0.0866,616091978
2016年09月,苗栗縣,374640389,148,0.8993,41962872,1341,0.1007,416603261
2016年09月,彰化縣,291668016,273,0.623,176490146,15979,0.377,468158162
2016年09月,南投縣,66337220,92,0.7105,27031773,1122,0.2895,93368993
2016年09月,雲林縣,207839552,89,0.8412,39242998,2524,0.1588,247082550
2016年09月,嘉義縣,36850564,56,0.4785,40170133,2126,0.5215,77020697
2016年09月,屏東縣,49838985,118,0.5864,35158450,1849,0.4136,84997435
2016年09月,台東縣,8168900,3,0.7847,2241584,383,0.2153,10410484
2016年09月,花蓮縣,69938700,21,0.8634,11065947,597,0.1366,81004647
2016年09月,基隆市,9903688,13,0.5465,8218028,375,0.4535,18121716
2016年09月,新竹市,643621492,123,0.9554,30055365,1675,0.0446,673676857
2016年09月,嘉義市,1925800,4,0.2621,5423083,648,0.7379,7348883
2016年09月,澎湖縣,1203200,1,0.3484,2250724,274,0.6516,3453924
2016年09月,金門縣,1562000,2,0.5,1562009,179,0.5,3124009
2016年09月,連江縣,0,0,0,516744,59,1,516744
2016年09月,合計,7460440839,3569,0.8234,1600614612,83557,0.1766,9061055451
2016年08月,新北市,230176939,223,0.464,265931563,14477,0.536,496108502
2016年08月,台北市,22480800,21,0.5404,19120941,1639,0.4596,41601741
2016年08月,桃園市,1431341726,761,0.8354,281938162,7019,0.1646,1713279888
2016年08月,台中市,1050009749,389,0.8054,253702135,10951,0.1946,1303711884
2016年08月,台南市,1484300047,430,0.8717,218478316,11127,0.1283,1702778363
2016年08月,高雄市,1224344249,520,0.8761,173094374,6313,0.1239,1397438623
2016年08月,宜蘭縣,107514230,65,0.7683,32428241,1398,0.2317,139942471
2016年08月,新竹縣,589159899,223,0.9096,58533185,1505,0.0904,647693084
2016年08月,苗栗縣,413290046,148,0.898,46931655,1345,0.102,460221701
2016年08月,彰化縣,323292360,272,0.6275,191907196,15988,0.3725,515199556
2016年08月,南投縣,73027660,92,0.7043,30659073,1121,0.2957,103686733
2016年08月,雲林縣,218830252,90,0.8344,43441646,2523,0.1656,262271898
2016年08月,嘉義縣,42366160,56,0.505,41521134,2122,0.495,83887294
2016年08月,屏東縣,59693758,118,0.6095,38245861,1849,0.3905,97939619
2016年08月,台東縣,8326000,3,0.7662,2540054,383,0.2338,10866054
2016年08月,花蓮縣,76377600,21,0.8527,13198091,600,0.1473,89575691
2016年08月,基隆市,9985100,13,0.5222,9137896,377,0.4778,19122996
2016年08月,新竹市,675051402,123,0.9533,33066853,1677,0.0467,708118255
2016年08月,嘉義市,2133880,4,0.2687,5806714,647,0.7313,7940594
2016年08月,澎湖縣,1247200,1,0.3321,2508470,275,0.6679,3755670
2016年08月,金門縣,1863600,2,0.5127,1771586,180,0.4873,3635186
2016年08月,連江縣,0,0,0,551701,59,1,551701
2016年08月,合計,8044812657,3575,0.8201,1764514847,83575,0.1799,9809327504
2016年07月,新北市,228539661,222,0.4742,253437403,14494,0.5258,481977064
2016年07月,台北市,22711000,21,0.5567,18088175,1642,0.4433,40799175
2016年07月,桃園市,1417777791,761,0.8406,268870267,7018,0.1594,1686648058
2016年07月,台中市,1033032947,386,0.8099,242451254,10944,0.1901,1275484201
2016年07月,台南市,1476563239,431,0.8762,208560746,11122,0.1238,1685123985
2016年07月,高雄市,1228773989,519,0.8809,166099458,6308,0.1191,1394873447
2016年07月,宜蘭縣,108497496,64,0.7788,30816762,1397,0.2212,139314258
2016年07月,新竹縣,591455594,221,0.9113,57581622,1505,0.0887,649037216
2016年07月,苗栗縣,422643954,146,0.9035,45133823,1344,0.0965,467777777
2016年07月,彰化縣,317860100,270,0.6282,188141293,15988,0.3718,506001393
2016年07月,南投縣,70768600,91,0.7042,29730830,1120,0.2958,100499430
2016年07月,雲林縣,210923232,91,0.8336,42107287,2529,0.1664,253030519
2016年07月,嘉義縣,41915880,56,0.5044,41180972,2117,0.4956,83096852
2016年07月,屏東縣,58600748,116,0.6067,37989859,1849,0.3933,96590607
2016年07月,台東縣,7949000,3,0.7687,2392049,384,0.2313,10341049
2016年07月,花蓮縣,77268900,21,0.8628,12282881,599,0.1372,89551781
2016年07月,基隆市,10346448,13,0.54,8812428,377,0.46,19158876
2016年07月,新竹市,672228085,124,0.9552,31521401,1678,0.0448,703749486
2016年07月,嘉義市,1983960,4,0.2625,5573100,646,0.7375,7557060
2016年07月,澎湖縣,1262000,1,0.3379,2472732,274,0.6621,3734732
2016年07月,金門縣,1878400,2,0.521,1727172,180,0.479,3605572
2016年07月,連江縣,0,0,0,538304,59,1,538304
2016年07月,合計,8002981024,3563,0.8252,1695509818,83574,0.1748,9698490842
2016年06月,新北市,218089832,225,0.4775,238655276,14497,0.5225,456745108
2016年06月,台北市,21441400,21,0.5648,16520081,1651,0.4352,37961481
2016年06月,桃園市,1371425199,763,0.8413,258790915,7026,0.1587,1630216114
2016年06月,台中市,983200540,386,0.807,235101998,10950,0.193,1218302538
2016年06月,台南市,1420310504,429,0.8737,205228553,11123,0.1263,1625539057
2016年06月,高雄市,1179561937,517,0.8784,163360638,6310,0.1216,1342922575
2016年06月,宜蘭縣,100366280,65,0.7725,29549366,1394,0.2275,129915646
2016年06月,新竹縣,566019202,219,0.9117,54835348,1502,0.0883,620854550
2016年06月,苗栗縣,402625485,148,0.9036,42947412,1341,0.0964,445572897
2016年06月,彰化縣,303881180,271,0.624,183126976,15999,0.376,487008156
2016年06月,南投縣,69021900,89,0.7027,29200347,1118,0.2973,98222247
2016年06月,雲林縣,200681764,90,0.8324,40403884,2521,0.1676,241085648
2016年06月,嘉義縣,39720820,56,0.5083,38424476,2117,0.4917,78145296
2016年06月,屏東縣,55479706,115,0.597,37453860,1851,0.403,92933566
2016年06月,台東縣,8239155,3,0.7728,2421925,380,0.2272,10661080
2016年06月,花蓮縣,74648300,21,0.8622,11933312,599,0.1378,86581612
2016年06月,基隆市,10334400,13,0.5551,8283541,379,0.4449,18617941
2016年06月,新竹市,651386170,124,0.9559,30019139,1675,0.0441,681405309
2016年06月,嘉義市,1982760,4,0.2691,5385140,650,0.7309,7367900
2016年06月,澎湖縣,1272000,1,0.3517,2344931,274,0.6483,3616931
2016年06月,金門縣,1749600,2,0.5155,1644253,182,0.4845,3393853
2016年06月,連江縣,0,0,0,509418,59,1,509418
2016年06月,合計,7681438134,3562,0.8244,1636140789,83598,0.1756,9317578923
2016年05月,新北市,225727632,224,0.4895,235441911,14504,0.5105,461169543
2016年05月,台北市,21360700,21,0.5718,15993393,1658,0.4282,37354093
2016年05月,桃園市,1382114750,760,0.8407,261829290,7033,0.1593,1643944040
2016年05月,台中市,1017726090,385,0.8116,236261109,10958,0.1884,1253987199
2016年05月,台南市,1443697597,430,0.8742,207726857,11122,0.1258,1651424454
2016年05月,高雄市,1265302870,519,0.8846,165123079,6307,0.1154,1430425949
2016年05月,宜蘭縣,106622300,62,0.7863,28973880,1397,0.2137,135596180
2016年05月,新竹縣,570112082,219,0.9125,54639197,1508,0.0875,624751279
2016年05月,苗栗縣,411349492,146,0.9035,43922310,1343,0.0965,455271802
2016年05月,彰化縣,320728591,270,0.641,179611033,16008,0.359,500339624
2016年05月,南投縣,71176560,89,0.7074,29445750,1117,0.2926,100622310
2016年05月,雲林縣,202156268,89,0.8328,40577161,2521,0.1672,242733429
2016年05月,嘉義縣,40615067,57,0.5108,38902190,2119,0.4892,79517257
2016年05月,屏東縣,59209898,115,0.6085,38096965,1852,0.3915,97306863
2016年05月,台東縣,8288226,3,0.7783,2360349,378,0.2217,10648575
2016年05月,花蓮縣,74675600,21,0.8623,11920208,599,0.1377,86595808
2016年05月,基隆市,9794900,14,0.5558,7827609,377,0.4442,17622509
2016年05月,新竹市,659256306,124,0.9575,29274590,1678,0.0425,688530896
2016年05月,嘉義市,2024840,4,0.2669,5562410,650,0.7331,7587250
2016年05月,澎湖縣,1280800,1,0.3506,2372603,273,0.6494,3653403
2016年05月,金門縣,1659200,2,0.5208,1526460,183,0.4792,3185660
2016年05月,連江縣,0,0,0,465583,59,1,465583
2016年05月,合計,7894879769,3555,0.8282,1637853937,83644,0.1718,9532733706
2016年04月,新北市,217335684,222,0.5125,206753584,14515,0.4875,424089268
2016年04月,台北市,19301500,21,0.5827,13825578,1660,0.4173,33127078
2016年04月,桃園市,1290422911,754,0.8381,249360900,7043,0.1619,1539783811
2016年04月,台中市,940523338,389,0.8172,210392911,10950,0.1828,1150916249
2016年04月,台南市,1373925688,432,0.8816,184458098,11121,0.1184,1558383786
2016年04月,高雄市,1205625585,517,0.8822,161051379,6317,0.1178,1366676964
2016年04月,宜蘭縣,100461420,62,0.7933,26174155,1398,0.2067,126635575
2016年04月,新竹縣,523905608,218,0.9162,47941710,1512,0.0838,571847318
2016年04月,苗栗縣,404433384,144,0.9089,40538315,1346,0.0911,444971699
2016年04月,彰化縣,302461798,269,0.6488,163732520,16016,0.3512,466194318
2016年04月,南投縣,66580900,88,0.7098,27224643,1119,0.2902,93805543
2016年04月,雲林縣,187629956,89,0.8368,36603414,2515,0.1632,224233370
2016年04月,嘉義縣,37263432,55,0.4445,46564922,2122,0.5555,83828354
2016年04月,屏東縣,53632879,114,0.6086,34485987,1851,0.3914,88118866
2016年04月,台東縣,8134800,3,0.7988,2048780,377,0.2012,10183580
2016年04月,花蓮縣,71258260,19,0.864,11217163,600,0.136,82475423
2016年04月,基隆市,9098700,14,0.5471,7530799,381,0.4529,16629499
2016年04月,新竹市,614264204,124,0.9595,25911640,1681,0.0405,640175844
2016年04月,嘉義市,1860640,4,0.287,4621899,649,0.713,6482539
2016年04月,澎湖縣,1216400,1,0.3799,1985304,273,0.6201,3201704
2016年04月,金門縣,695600,2,0.3322,1398340,183,0.6678,2093940
2016年04月,連江縣,0,0,0,360599,59,1,360599
2016年04月,合計,7430032687,3541,0.8316,1504182640,83688,0.1684,8934215327
2016年03月,新北市,225434632,223,0.5346,196260925,14506,0.4654,421695557
2016年03月,台北市,19862200,21,0.6082,12797402,1662,0.3918,32659602
2016年03月,桃園市,1292782341,752,0.8441,238698934,7052,0.1559,1531481275
2016年03月,台中市,948228897,391,0.8198,208409078,10966,0.1802,1156637975
2016年03月,台南市,1363722071,431,0.8813,183672934,11124,0.1187,1547395005
2016年03月,高雄市,1188514362,515,0.8798,162359008,6327,0.1202,1350873370
2016年03月,宜蘭縣,106362000,60,0.8006,26496987,1397,0.1994,132858987
2016年03月,新竹縣,515707854,217,0.9149,47964340,1513,0.0851,563672194
2016年03月,苗栗縣,391500783,146,0.9103,38599042,1339,0.0897,430099825
2016年03月,彰化縣,297677091,268,0.6481,161607552,16026,0.3519,459284643
2016年03月,南投縣,64992256,89,0.7005,27782819,1117,0.2995,92775075
2016年03月,雲林縣,188622020,88,0.8374,36630238,2517,0.1626,225252258
2016年03月,嘉義縣,37776020,56,0.5197,34917251,2120,0.4803,72693271
2016年03月,屏東縣,54593014,112,0.6189,33616590,1852,0.3811,88209604
2016年03月,台東縣,8051900,3,0.7993,2021427,375,0.2007,10073327
2016年03月,花蓮縣,73221640,18,0.8638,11549453,599,0.1362,84771093
2016年03月,基隆市,9032000,13,0.5409,7664727,380,0.4591,16696727
2016年03月,新竹市,618146848,124,0.9612,24929426,1683,0.0388,643076274
2016年03月,嘉義市,2123120,4,0.3266,4378546,650,0.6734,6501666
2016年03月,澎湖縣,1284400,1,0.3964,1955559,273,0.6036,3239959
2016年03月,金門縣,698400,2,0.3505,1294088,183,0.6495,1992488
2016年03月,連江縣,0,0,0,452720,59,1,452720
2016年03月,合計,7408333849,3534,0.835,1464059046,83720,0.165,8872392895
2016年02月,新北市,175123622,224,0.5159,164312753,14507,0.4841,339436375
2016年02月,台北市,17193300,20,0.6005,11437966,1667,0.3995,28631266
2016年02月,桃園市,1062112538,757,0.8545,180843653,7048,0.1455,1242956191
2016年02月,台中市,789227807,390,0.833,158174219,10971,0.167,947402026
2016年02月,台南市,1118827420,432,0.8868,142878814,11119,0.1132,1261706234
2016年02月,高雄市,1030054303,514,0.899,115746735,6329,0.101,1145801038
2016年02月,宜蘭縣,83986556,60,0.8024,20677778,1396,0.1976,104664334
2016年02月,新竹縣,451284547,215,0.9097,44817778,1515,0.0903,496102325
2016年02月,苗栗縣,341820722,147,0.9195,29941121,1341,0.0805,371761843
2016年02月,彰化縣,223998514,269,0.6321,130356369,16024,0.3679,354354883
2016年02月,南投縣,49319000,89,0.7044,20699912,1118,0.2956,70018912
2016年02月,雲林縣,161132446,88,0.8452,29511941,2517,0.1548,190644387
2016年02月,嘉義縣,27682572,56,0.5039,27256671,2122,0.4961,54939243
2016年02月,屏東縣,39931837,111,0.5915,27579811,1850,0.4085,67511648
2016年02月,台東縣,6189100,3,0.7764,1782046,375,0.2236,7971146
2016年02月,花蓮縣,66522500,17,0.8683,10093713,595,0.1317,76616213
2016年02月,基隆市,7822200,14,0.5744,5796671,382,0.4256,13618871
2016年02月,新竹市,560860592,126,0.9646,20565483,1686,0.0354,581426075
2016年02月,嘉義市,1247080,4,0.2437,3869461,650,0.7563,5116541
2016年02月,澎湖縣,1213600,1,0.4187,1685145,273,0.5813,2898745
2016年02月,金門縣,494000,2,0.3004,1150246,185,0.6996,1644246
2016年02月,連江縣,0,0,0,438243,59,1,438243
2016年02月,合計,6216044256,3539,0.8439,1149616529,83729,0.1561,7365660785
2016年01月,新北市,198790107,226,0.4934,204102268,14511,0.5066,402892375
2016年01月,台北市,19213500,20,0.5844,13665520,1679,0.4156,32879020
2016年01月,桃園市,1250640864,756,0.8435,232031466,7059,0.1565,1482672330
2016年01月,台中市,910436755,391,0.817,203904658,10978,0.183,1114341413
2016年01月,台南市,1309071566,433,0.88,178508184,11128,0.12,1487579750
2016年01月,高雄市,1160006912,516,0.8913,141535294,6329,0.1087,1301542206
2016年01月,宜蘭縣,108076500,60,0.8055,26093478,1397,0.1945,134169978
2016年01月,新竹縣,506473478,216,0.9151,46990005,1523,0.0849,553463483
2016年01月,苗栗縣,390692379,147,0.9084,39396736,1337,0.0916,430089115
2016年01月,彰化縣,278749709,271,0.6326,161882026,16022,0.3674,440631735
2016年01月,南投縣,61145570,88,0.6987,26372188,1115,0.3013,87517758
2016年01月,雲林縣,185212730,87,0.834,36875941,2505,0.166,222088671
2016年01月,嘉義縣,34478104,56,0.4873,36281132,2124,0.5127,70759236
2016年01月,屏東縣,50909783,114,0.6025,33583100,1846,0.3975,84492883
2016年01月,台東縣,8106800,3,0.791,2141440,373,0.209,10248240
2016年01月,花蓮縣,72748300,18,0.8547,12370683,594,0.1453,85118983
2016年01月,基隆市,9625320,15,0.5652,7403223,385,0.4348,17028543
2016年01月,新竹市,605207970,128,0.9623,23693482,1689,0.0377,628901452
2016年01月,嘉義市,1890760,4,0.2936,4548785,651,0.7064,6439545
2016年01月,澎湖縣,1294800,1,0.3955,1978691,273,0.6045,3273491
2016年01月,金門縣,624800,2,0.3101,1389953,184,0.6899,2014753
2016年01月,連江縣,0,0,0,435340,59,1,435340
2016年01月,合計,7163396707,3552,0.8331,1435183593,83761,0.1669,8598580300
2015年12月,新北市,216492055,227,0.5001,216443740,14501,0.4999,432935795
2015年12月,台北市,20195500,20,0.5798,14634590,1692,0.4202,34830090
2015年12月,桃園市,1295794363,763,0.8378,250945327,7076,0.1622,1546739690
2015年12月,台中市,952349275,392,0.8156,215271963,10998,0.1844,1167621238
2015年12月,台南市,1353045231,436,0.8759,191692416,11128,0.1241,1544737647
2015年12月,高雄市,1161435962,516,0.8839,152517243,6339,0.1161,1313953205
2015年12月,宜蘭縣,106257260,60,0.8013,26349640,1399,0.1987,132606900
2015年12月,新竹縣,511152343,217,0.9123,49123700,1527,0.0877,560276043
2015年12月,苗栗縣,393556475,148,0.9078,39992968,1331,0.0922,433549443
2015年12月,彰化縣,305442459,272,0.6449,168197320,16018,0.3551,473639779
2015年12月,南投縣,63217940,88,0.6931,27986910,1117,0.3069,91204850
2015年12月,雲林縣,193159356,87,0.8324,38898716,2509,0.1676,232058072
2015年12月,嘉義縣,36094840,56,0.4925,37198576,2119,0.5075,73293416
2015年12月,屏東縣,55806686,113,0.6132,35205839,1841,0.3868,91012525
2015年12月,台東縣,8186600,3,0.7819,2282979,373,0.2181,10469579
2015年12月,花蓮縣,81957000,18,0.8635,12950435,594,0.1365,94907435
2015年12月,基隆市,10926580,17,0.5747,8084923,382,0.4253,19011503
2015年12月,新竹市,615060802,128,0.9608,25068033,1693,0.0392,640128835
2015年12月,嘉義市,2063200,4,0.2956,4917078,652,0.7044,6980278
2015年12月,澎湖縣,1349200,1,0.4059,1974746,272,0.5941,3323946
2015年12月,金門縣,897200,2,0.3896,1405548,184,0.6104,2302748
2015年12月,連江縣,0,0,0,397273,59,1,397273
2015年12月,合計,7384440327,3568,0.8292,1521539963,83804,0.1708,8905980290
2015年11月,新北市,198577854,226,0.4718,222323644,14508,0.5282,420901498
2015年11月,台北市,20529400,21,0.5723,15339539,1697,0.4277,35868939
2015年11月,桃園市,1285306757,770,0.842,241121649,7066,0.158,1526428406
2015年11月,台中市,889967315,391,0.8047,216031177,11010,0.1953,1105998492
2015年11月,台南市,1325816411,434,0.8728,193156405,11124,0.1272,1518972816
2015年11月,高雄市,1149918530,517,0.8809,155483754,6347,0.1191,1305402284
2015年11月,宜蘭縣,104061340,60,0.7961,26648279,1400,0.2039,130709619
2015年11月,新竹縣,514867943,219,0.9113,50125148,1524,0.0887,564993091
2015年11月,苗栗縣,385527617,147,0.9073,39373501,1327,0.0927,424901118
2015年11月,彰化縣,292712584,273,0.6327,169930390,16042,0.3673,462642974
2015年11月,南投縣,58540780,89,0.6803,27516937,1116,0.3197,86057717
2015年11月,雲林縣,193869620,87,0.8322,39100093,2496,0.1678,232969713
2015年11月,嘉義縣,36212020,55,0.491,37534819,2117,0.509,73746839
2015年11月,屏東縣,53268992,113,0.5965,36027853,1831,0.4035,89296845
2015年11月,台東縣,7773500,3,0.78,2192033,374,0.22,9965533
2015年11月,花蓮縣,72284600,18,0.8487,12889892,593,0.1513,85174492
2015年11月,基隆市,10135223,17,0.5551,8121537,382,0.4449,18256760
2015年11月,新竹市,623845364,127,0.9596,26233480,1691,0.0404,650078844
2015年11月,嘉義市,1872200,4,0.2671,5136475,652,0.7329,7008675
2015年11月,澎湖縣,1278400,1,0.3832,2057301,272,0.6168,3335701
2015年11月,金門縣,1496000,2,0.5069,1455500,185,0.4931,2951500
2015年11月,連江縣,0,0,0,418488,59,1,418488
2015年11月,合計,7227862450,3574,0.8255,1528217894,83813,0.1745,8756080344
2015年10月,新北市,211256963,226,0.4708,237476808,14528,0.5292,448733771
2015年10月,台北市,21341600,21,0.5607,16720943,1689,0.4393,38062543
2015年10月,桃園市,1371687255,768,0.8428,255923937,7051,0.1572,1627611192
2015年10月,台中市,930490610,394,0.8025,229036609,11015,0.1975,1159527219
2015年10月,台南市,1391610068,434,0.8744,199882981,11139,0.1256,1591493049
2015年10月,高雄市,1180463656,514,0.8748,169022375,6351,0.1252,1349486031
2015年10月,宜蘭縣,102408357,59,0.7812,28687184,1401,0.2188,131095541
2015年10月,新竹縣,526929471,219,0.907,54059437,1525,0.093,580988908
2015年10月,苗栗縣,407535532,148,0.9078,41407248,1329,0.0922,448942780
2015年10月,彰化縣,298395448,273,0.6258,178443362,16055,0.3742,476838810
2015年10月,南投縣,65399020,90,0.6967,28474160,1116,0.3033,93873180
2015年10月,雲林縣,210906704,86,0.8373,40994605,2483,0.1627,251901309
2015年10月,嘉義縣,38474320,56,0.4972,38904749,2121,0.5028,77379069
2015年10月,屏東縣,53540358,113,0.59,37200855,1829,0.41,90741213
2015年10月,台東縣,7734100,3,0.7774,2214144,374,0.2226,9948244
2015年10月,花蓮縣,73500300,19,0.8434,13649634,588,0.1566,87149934
2015年10月,基隆市,10692100,17,0.5477,8828157,381,0.4523,19520257
2015年10月,新竹市,644884372,127,0.9574,28708623,1694,0.0426,673592995
2015年10月,嘉義市,1884320,4,0.2561,5474435,654,0.7439,7358755
2015年10月,澎湖縣,1332800,1,0.3827,2149752,272,0.6173,3482552
2015年10月,金門縣,1528400,2,0.4953,1557406,185,0.5047,3085806
2015年10月,連江縣,0,0,0,438992,59,1,438992
2015年10月,合計,7551995754,3574,0.8234,1619256396,83839,0.1766,9171252150
2015年09月,新北市,205111536,227,0.456,244656143,14522,0.544,449767679
2015年09月,台北市,20539000,21,0.5432,17270846,1687,0.4568,37809846
2015年09月,桃園市,1319536468,764,0.837,256956881,7048,0.163,1576493349
2015年09月,台中市,891238166,397,0.7985,224913173,11020,0.2015,1116151339
2015年09月,台南市,1364172596,436,0.8726,199177650,11138,0.1274,1563350246
2015年09月,高雄市,1066900294,514,0.8698,159649762,6364,0.1302,1226550056
2015年09月,宜蘭縣,101867900,58,0.7814,28505826,1400,0.2186,130373726
2015年09月,新竹縣,514443487,221,0.905,54020138,1532,0.095,568463625
2015年09月,苗栗縣,395820018,147,0.9077,40237840,1330,0.0923,436057858
2015年09月,彰化縣,288760316,272,0.624,173982477,16060,0.376,462742793
2015年09月,南投縣,65809900,90,0.7032,27780364,1116,0.2968,93590264
2015年09月,雲林縣,202880348,86,0.8381,39181014,2477,0.1619,242061362
2015年09月,嘉義縣,36957160,55,0.4907,38353294,2121,0.5093,75310454
2015年09月,屏東縣,52405402,114,0.5907,36317264,1827,0.4093,88722666
2015年09月,台東縣,7883000,3,0.7692,2365636,373,0.2308,10248636
2015年09月,花蓮縣,67252800,19,0.812,15575638,586,0.188,82828438
2015年09月,基隆市,10305921,17,0.5396,8794663,381,0.4604,19100584
2015年09月,新竹市,639387836,127,0.9568,28880929,1692,0.0432,668268765
2015年09月,嘉義市,1893680,4,0.2523,5611230,653,0.7477,7504910
2015年09月,澎湖縣,1274000,1,0.3599,2265812,274,0.6401,3539812
2015年09月,金門縣,1675600,2,0.5048,1643440,185,0.4952,3319040
2015年09月,連江縣,0,0,0,505343,59,1,505343
2015年09月,合計,7256115428,3575,0.8187,1606645363,83845,0.1813,8862760791
2015年08月,新北市,215763149,228,0.4606,252656965,14518,0.5394,468420114
2015年08月,台北市,21561000,21,0.5434,18114540,1693,0.4566,39675540
2015年08月,桃園市,1364983217,764,0.8356,268568035,7069,0.1644,1633551252
2015年08月,台中市,920941369,396,0.7966,235095366,11028,0.2034,1156036735
2015年08月,台南市,1397580852,438,0.8737,202013894,11134,0.1263,1599594746
2015年08月,高雄市,1169329783,516,0.8775,163249930,6350,0.1225,1332579713
2015年08月,宜蘭縣,103120360,58,0.7778,29461151,1401,0.2222,132581511
2015年08月,新竹縣,547929965,221,0.9023,59298872,1531,0.0977,607228837
2015年08月,苗栗縣,400627047,147,0.906,41548690,1332,0.094,442175737
2015年08月,彰化縣,292044412,271,0.6177,180733515,16056,0.3823,472777927
2015年08月,南投縣,67293760,90,0.7003,28803707,1116,0.2997,96097467
2015年08月,雲林縣,205245880,85,0.8329,41177596,2479,0.1671,246423476
2015年08月,嘉義縣,38911680,54,0.5018,38626503,2120,0.4982,77538183
2015年08月,屏東縣,54000349,110,0.5875,37919055,1831,0.4125,91919404
2015年08月,台東縣,8082200,3,0.7689,2428719,373,0.2311,10510919
2015年08月,花蓮縣,77751700,19,0.8426,14523186,582,0.1574,92274886
2015年08月,基隆市,10758300,16,0.547,8910502,381,0.453,19668802
2015年08月,新竹市,676105703,128,0.9567,30629848,1691,0.0433,706735551
2015年08月,嘉義市,1991160,4,0.2606,5650079,652,0.7394,7641239
2015年08月,澎湖縣,1363200,1,0.364,2381451,274,0.636,3744651
2015年08月,金門縣,1838000,2,0.5199,1697578,185,0.4801,3535578
2015年08月,連江縣,0,0,0,504908,58,1,504908
2015年08月,合計,7577223086,3572,0.8199,1663994090,83854,0.1801,9241217176
2015年07月,新北市,228006082,230,0.4613,266209065,14510,0.5387,494215147
2015年07月,台北市,22202700,21,0.5324,19499051,1702,0.4676,41701751
2015年07月,桃園市,1428422513,763,0.8344,283589535,7050,0.1656,1712012048
2015年07月,台中市,958866336,391,0.7905,254094725,11019,0.2095,1212961061
2015年07月,台南市,1436552564,440,0.8686,217282221,11142,0.1314,1653834785
2015年07月,高雄市,1218812127,517,0.8705,181351141,6350,0.1295,1400163268
2015年07月,宜蘭縣,105059980,58,0.7613,32945955,1399,0.2387,138005935
2015年07月,新竹縣,559864657,218,0.9031,60050289,1532,0.0969,619914946
2015年07月,苗栗縣,414060968,148,0.9039,44043217,1327,0.0961,458104185
2015年07月,彰化縣,314947881,270,0.6183,194443530,16065,0.3817,509391411
2015年07月,南投縣,71809000,89,0.6988,30956709,1110,0.3012,102765709
2015年07月,雲林縣,215686996,85,0.8317,43637496,2470,0.1683,259324492
2015年07月,嘉義縣,39733960,55,0.4926,40924364,2115,0.5074,80658324
2015年07月,屏東縣,57919793,110,0.5906,40146408,1836,0.4094,98066201
2015年07月,台東縣,7859000,3,0.7489,2634709,375,0.2511,10493709
2015年07月,花蓮縣,84462800,19,0.8475,15195993,583,0.1525,99658793
2015年07月,基隆市,11440373,16,0.5435,9610695,382,0.4565,21051068
2015年07月,新竹市,692923188,127,0.9552,32522879,1694,0.0448,725446067
2015年07月,嘉義市,2187400,4,0.2646,6077928,654,0.7354,8265328
2015年07月,澎湖縣,1568800,1,0.3927,2426564,274,0.6073,3995364
2015年07月,金門縣,1975600,2,0.529,1758972,185,0.471,3734572
2015年07月,連江縣,0,0,0,527957,58,1,527957
2015年07月,合計,7874362718,3567,0.8156,1779929403,83832,0.1844,9654292121
2015年06月,新北市,215684009,229,0.4794,234211082,14486,0.5206,449895091
2015年06月,台北市,21068700,21,0.5595,16584252,1713,0.4405,37652952
2015年06月,桃園市,1350560350,761,0.8388,259465592,7038,0.1612,1610025942
2015年06月,台中市,939559035,389,0.8028,230805284,11016,0.1972,1170364319
2015年06月,台南市,1394921692,439,0.8754,198558603,11138,0.1246,1593480295
2015年06月,高雄市,1139729591,515,0.8758,161631407,6364,0.1242,1301360998
2015年06月,宜蘭縣,103944300,58,0.7823,28919781,1396,0.2177,132864081
2015年06月,新竹縣,535676084,218,0.9071,54832828,1538,0.0929,590508912
2015年06月,苗栗縣,396955788,149,0.9062,41109036,1326,0.0938,438064824
2015年06月,彰化縣,301831960,270,0.6331,174892577,16069,0.3669,476724537
2015年06月,南投縣,68163860,89,0.7023,28898859,1112,0.2977,97062719
2015年06月,雲林縣,201261028,84,0.8352,39725603,2472,0.1648,240986631
2015年06月,嘉義縣,38555000,57,0.5096,37108809,2114,0.4904,75663809
2015年06月,屏東縣,55864716,111,0.6006,37157514,1834,0.3994,93022230
2015年06月,台東縣,7579700,3,0.7651,2326696,376,0.2349,9906396
2015年06月,花蓮縣,76415800,19,0.8482,13677491,582,0.1518,90093291
2015年06月,基隆市,10862800,17,0.5594,8555262,381,0.4406,19418062
2015年06月,新竹市,671872999,126,0.9583,29206646,1695,0.0417,701079645
2015年06月,嘉義市,2454680,4,0.3222,5164941,653,0.6778,7619621
2015年06月,澎湖縣,1510400,1,0.4068,2202219,275,0.5932,3712619
2015年06月,金門縣,1806000,2,0.5296,1603954,185,0.4704,3409954
2015年06月,連江縣,0,0,0,515507,58,1,515507
2015年06月,合計,7536278492,3562,0.8242,1607153943,83821,0.1758,9143432435
2015年05月,新北市,212416524,230,0.4816,228612578,14478,0.5184,441029102
2015年05月,台北市,20468200,22,0.5659,15701067,1715,0.4341,36169267
2015年05月,桃園市,1351004019,760,0.8391,259065758,7034,0.1609,1610069777
2015年05月,台中市,952738659,385,0.8043,231768968,11015,0.1957,1184507627
2015年05月,台南市,1396332436,437,0.8746,200165032,11141,0.1254,1596497468
2015年05月,高雄市,1201135106,511,0.8756,170703115,6370,0.1244,1371838221
2015年05月,宜蘭縣,109217640,58,0.795,28162329,1392,0.205,137379969
2015年05月,新竹縣,531279282,220,0.9093,52996643,1532,0.0907,584275925
2015年05月,苗栗縣,401853252,148,0.9031,43137293,1318,0.0969,444990545
2015年05月,彰化縣,313311480,268,0.6358,179493170,16070,0.3642,492804650
2015年05月,南投縣,66970200,88,0.6956,29305046,1113,0.3044,96275246
2015年05月,雲林縣,204596908,83,0.839,39262190,2462,0.161,243859098
2015年05月,嘉義縣,41247660,57,0.5218,37794831,2107,0.4782,79042491
2015年05月,屏東縣,56880588,111,0.6062,36951429,1834,0.3938,93832017
2015年05月,台東縣,8082700,3,0.784,2227363,375,0.216,10310063
2015年05月,花蓮縣,79749100,20,0.8547,13562545,581,0.1453,93311645
2015年05月,基隆市,10936000,17,0.56,8591482,380,0.44,19527482
2015年05月,新竹市,671904023,126,0.9592,28581668,1695,0.0408,700485691
2015年05月,嘉義市,2393040,4,0.3116,5286272,653,0.6884,7679312
2015年05月,澎湖縣,1738800,1,0.4257,2345562,275,0.5743,4084362
2015年05月,金門縣,1556000,2,0.5053,1523178,185,0.4947,3079178
2015年05月,連江縣,0,0,0,456540,58,1,456540
2015年05月,合計,7635811617,3551,0.8254,1615694059,83783,0.1746,9251505676
2015年04月,新北市,202241644,230,0.4917,209088662,14463,0.5083,411330306
2015年04月,台北市,20102200,21,0.5909,13914893,1722,0.4091,34017093
2015年04月,桃園市,1305002004,758,0.8407,247303511,7028,0.1593,1552305515
2015年04月,台中市,905131576,382,0.8064,217234903,11002,0.1936,1122366479
2015年04月,台南市,1345096066,438,0.8778,187286072,11145,0.1222,1532382138
2015年04月,高雄市,1156470921,511,0.8785,159905102,6369,0.1215,1316376023
2015年04月,宜蘭縣,106089880,59,0.804,25866912,1390,0.196,131956792
2015年04月,新竹縣,487957493,221,0.9116,47342377,1523,0.0884,535299870
2015年04月,苗栗縣,386388820,148,0.9091,38651653,1318,0.0909,425040473
2015年04月,彰化縣,299039116,269,0.6363,170950561,16076,0.3637,469989677
2015年04月,南投縣,69017260,88,0.7121,27896945,1116,0.2879,96914205
2015年04月,雲林縣,191221112,84,0.838,36975289,2460,0.162,228196401
2015年04月,嘉義縣,38175540,57,0.5209,35112214,2104,0.4791,73287754
2015年04月,屏東縣,56014562,111,0.6219,34055351,1833,0.3781,90069913
2015年04月,台東縣,7277400,3,0.7789,2065788,373,0.2211,9343188
2015年04月,花蓮縣,77880900,20,0.8553,13172907,580,0.1447,91053807
2015年04月,基隆市,11010400,18,0.5951,7492064,380,0.4049,18502464
2015年04月,新竹市,627540601,126,0.9597,26331214,1700,0.0403,653871815
2015年04月,嘉義市,2157200,4,0.3083,4839055,655,0.6917,6996255
2015年04月,澎湖縣,1687200,1,0.4492,2068892,274,0.5508,3756092
2015年04月,金門縣,865200,2,0.3852,1381006,184,0.6148,2246206
2015年04月,連江縣,0,0,0,430455,58,1,430455
2015年04月,合計,7296367095,3551,0.8286,1509365826,83753,0.1714,8805732921
2015年03月,新北市,203666507,230,0.506,198827872,14478,0.494,402494379
2015年03月,台北市,21220240,22,0.612,13450882,1728,0.388,34671122
2015年03月,桃園市,1305673837,756,0.8434,242424490,7040,0.1566,1548098327
2015年03月,台中市,924113998,381,0.8129,212728547,11013,0.1871,1136842545
2015年03月,台南市,1354317308,434,0.8788,186714569,11153,0.1212,1541031877
2015年03月,高雄市,1186638346,510,0.8786,163901542,6363,0.1214,1350539888
2015年03月,宜蘭縣,112990400,59,0.8112,26292973,1389,0.1888,139283373
2015年03月,新竹縣,491220169,220,0.9137,46367492,1519,0.0863,537587661
2015年03月,苗栗縣,387771547,146,0.9117,37573134,1320,0.0883,425344681
2015年03月,彰化縣,301479380,269,0.6469,164566758,16089,0.3531,466046138
2015年03月,南投縣,69519860,88,0.7087,28571637,1116,0.2913,98091497
2015年03月,雲林縣,193728544,84,0.8417,36425965,2452,0.1583,230154509
2015年03月,嘉義縣,39325220,57,0.5319,34611693,2103,0.4681,73936913
2015年03月,屏東縣,55326040,110,0.6193,34004510,1833,0.3807,89330550
2015年03月,台東縣,9545800,3,0.8086,2260129,376,0.1914,11805929
2015年03月,花蓮縣,76598400,20,0.8514,13370172,580,0.1486,89968572
2015年03月,基隆市,11783506,18,0.6136,7421730,381,0.3864,19205236
2015年03月,新竹市,633895730,126,0.9613,25537230,1704,0.0387,659432960
2015年03月,嘉義市,2145880,4,0.3148,4670586,656,0.6852,6816466
2015年03月,澎湖縣,1752400,1,0.46,2057202,273,0.54,3809602
2015年03月,金門縣,702400,2,0.3538,1283174,184,0.6462,1985574
2015年03月,連江縣,0,0,0,440745,58,1,440745
2015年03月,合計,7383415512,3540,0.8327,1483503032,83808,0.1673,8866918544
2015年02月,新北市,157570684,230,0.4798,170854421,14458,0.5202,328425105
2015年02月,台北市,17620920,22,0.5986,11815803,1727,0.4014,29436723
2015年02月,桃園市,1053073559,757,0.8489,187498094,7043,0.1511,1240571653
2015年02月,台中市,759417443,382,0.8184,168462566,11007,0.1816,927880009
2015年02月,台南市,1149031508,430,0.8863,147425941,11158,0.1137,1296457449
2015年02月,高雄市,971644076,506,0.8923,117300464,6359,0.1077,1088944540
2015年02月,宜蘭縣,91599420,60,0.815,20794008,1388,0.185,112393428
2015年02月,新竹縣,419959265,219,0.9164,38313765,1520,0.0836,458273030
2015年02月,苗栗縣,319738088,146,0.9147,29802792,1322,0.0853,349540880
2015年02月,彰化縣,236419491,268,0.6322,137535624,16097,0.3678,373955115
2015年02月,南投縣,48670432,88,0.6952,21339258,1115,0.3048,70009690
2015年02月,雲林縣,158795696,84,0.8442,29308262,2444,0.1558,188103958
2015年02月,嘉義縣,29347460,56,0.5126,27901382,2101,0.4874,57248842
2015年02月,屏東縣,41752281,110,0.6037,27405762,1830,0.3963,69158043
2015年02月,台東縣,7481800,3,0.7936,1946332,376,0.2064,9428132
2015年02月,花蓮縣,73829600,20,0.8673,11299385,578,0.1327,85128985
2015年02月,基隆市,8909200,18,0.6014,5905935,381,0.3986,14815135
2015年02月,新竹市,561323550,127,0.965,20371280,1713,0.035,581694830
2015年02月,嘉義市,1538080,4,0.2735,4086001,660,0.7265,5624081
2015年02月,澎湖縣,1622400,1,0.4746,1795851,273,0.5254,3418251
2015年02月,金門縣,459200,2,0.3037,1052728,184,0.6963,1511928
2015年02月,連江縣,0,0,0,391824,58,1,391824
2015年02月,合計,6109804153,3533,0.8378,1182607478,83792,0.1622,7292411631
2015年01月,新北市,197227269,232,0.4812,212635193,14451,0.5188,409862462
2015年01月,台北市,20285280,22,0.584,14450551,1738,0.416,34735831
2015年01月,桃園市,1255881525,758,0.8388,241385598,7041,0.1612,1497267123
2015年01月,台中市,901517620,384,0.8052,218041355,11004,0.1948,1119558975
2015年01月,台南市,1308065537,435,0.8757,185646326,11158,0.1243,1493711863
2015年01月,高雄市,1113866164,507,0.8824,148468310,6346,0.1176,1262334474
2015年01月,宜蘭縣,112999140,61,0.8124,26098864,1386,0.1876,139098004
2015年01月,新竹縣,481718205,219,0.9106,47286016,1522,0.0894,529004221
2015年01月,苗栗縣,388442504,146,0.9112,37863305,1322,0.0888,426305809
2015年01月,彰化縣,291425271,269,0.6239,175709577,16097,0.3761,467134848
2015年01月,南投縣,64566689,89,0.7041,27131255,1115,0.2959,91697944
2015年01月,雲林縣,187030940,83,0.8354,36850174,2438,0.1646,223881114
2015年01月,嘉義縣,36786660,56,0.5028,36380752,2096,0.4972,73167412
2015年01月,屏東縣,53806449,110,0.6184,33196284,1826,0.3816,87002733
2015年01月,台東縣,8444200,3,0.7798,2384780,371,0.2202,10828980
2015年01月,花蓮縣,84218700,20,0.8569,14065794,579,0.1431,98284494
2015年01月,基隆市,10825400,18,0.5863,7637240,379,0.4137,18462640
2015年01月,新竹市,614922752,127,0.96,25606017,1720,0.04,640528769
2015年01月,嘉義市,2230720,4,0.3151,4847714,660,0.6849,7078434
2015年01月,澎湖縣,1454800,1,0.4027,2157817,273,0.5973,3612617
2015年01月,金門縣,722400,2,0.3581,1295098,184,0.6419,2017498
2015年01月,連江縣,0,0,0,433964,58,1,433964
2015年01月,合計,7136438225,3546,0.8264,1499571984,83764,0.1736,8636010209
2014年12月,新北市,201051657,230,0.49,209236795,14440,0.51,410288452
2014年12月,台北市,21943680,23,0.6042,14373029,1752,0.3958,36316709
2014年12月,桃園市,1306247857,759,0.8382,252076016,7038,0.1618,1558323873
2014年12月,台中市,893329529,386,0.8041,217576884,10990,0.1959,1110906413
2014年12月,台南市,1310106613,432,0.8751,187028619,11157,0.1249,1497135232
2014年12月,高雄市,1149890876,506,0.8843,150509406,6349,0.1157,1300400282
2014年12月,宜蘭縣,116546600,61,0.82,25585969,1382,0.18,142132569
2014年12月,新竹縣,483559184,219,0.9113,47051135,1528,0.0887,530610319
2014年12月,苗栗縣,404659865,146,0.9153,37468635,1323,0.0847,442128500
2014年12月,彰化縣,294624268,269,0.6347,169605762,16096,0.3653,464230030
2014年12月,南投縣,68180300,88,0.7096,27895764,1116,0.2904,96076064
2014年12月,雲林縣,194272536,84,0.8439,35939688,2424,0.1561,230212224
2014年12月,嘉義縣,37643040,56,0.4829,40311399,2094,0.5171,77954439
2014年12月,屏東縣,53731046,110,0.6191,33064193,1832,0.3809,86795239
2014年12月,台東縣,7822100,3,0.7827,2171099,371,0.2173,9993199
2014年12月,花蓮縣,78982900,20,0.8537,13533419,579,0.1463,92516319
2014年12月,基隆市,11405400,18,0.6014,7559287,381,0.3986,18964687
2014年12月,新竹市,623433187,128,0.9615,24976208,1722,0.0385,648409395
2014年12月,嘉義市,2515840,4,0.3445,4786323,660,0.6555,7302163
2014年12月,澎湖縣,1442800,1,0.4123,2056224,272,0.5877,3499024
2014年12月,金門縣,733200,2,0.3727,1234018,183,0.6273,1967218
2014年12月,連江縣,0,0,0,467329,58,1,467329
2014年12月,合計,7262122478,3545,0.8284,1504507201,83747,0.1716,8766629679
2014年11月,新北市,197626069,231,0.4678,224823779,14439,0.5322,422449848
2014年11月,台北市,21251660,24,0.5696,16059972,1750,0.4304,37311632
2014年11月,桃園市,1275615152,764,0.8404,242231062,7033,0.1596,1517846214
2014年11月,台中市,888964134,388,0.8,222280618,10991,0.2,1111244752
2014年11月,台南市,1300913893,435,0.8711,192453287,11161,0.1289,1493367180
2014年11月,高雄市,1156585881,507,0.8775,161517139,6363,0.1225,1318103020
2014年11月,宜蘭縣,115032774,61,0.8142,26243586,1383,0.1858,141276360
2014年11月,新竹縣,481987825,219,0.9069,49505302,1516,0.0931,531493127
2014年11月,苗栗縣,397392980,144,0.9111,38777686,1326,0.0889,436170666
2014年11月,彰化縣,289835628,268,0.6227,175579031,16098,0.3773,465414659
2014年11月,南投縣,66205860,87,0.7046,27756079,1112,0.2954,93961939
2014年11月,雲林縣,185283684,83,0.8314,37563154,2400,0.1686,222846838
2014年11月,嘉義縣,37238180,57,0.5019,36953142,2092,0.4981,74191322
2014年11月,屏東縣,53854484,110,0.6061,35002568,1826,0.3939,88857052
2014年11月,台東縣,7720100,3,0.7709,2294879,371,0.2291,10014979
2014年11月,花蓮縣,75462400,20,0.8499,13322353,578,0.1501,88784753
2014年11月,基隆市,11764900,18,0.5961,7971651,384,0.4039,19736551
2014年11月,新竹市,623247139,128,0.9583,27134976,1723,0.0417,650382115
2014年11月,嘉義市,2468960,4,0.3206,5232661,659,0.6794,7701621
2014年11月,澎湖縣,1290800,1,0.3709,2189222,271,0.6291,3480022
2014年11月,金門縣,906000,2,0.3996,1361150,184,0.6004,2267150
2014年11月,連江縣,0,0,0,417865,58,1,417865
2014年11月,合計,7190648503,3554,0.823,1546671162,83718,0.177,8737319665
2014年10月,新北市,212578932,232,0.4639,245703334,14435,0.5361,458282266
2014年10月,台北市,23642540,25,0.5588,18668397,1754,0.4412,42310937
2014年10月,桃園市,1371842456,766,0.8398,261604549,7019,0.1602,1633447005
2014年10月,台中市,927543274,389,0.7963,237291513,10996,0.2037,1164834787
2014年10月,台南市,1369621825,431,0.8696,205342909,11164,0.1304,1574964734
2014年10月,高雄市,1230724663,510,0.8781,170813771,6352,0.1219,1401538434
2014年10月,宜蘭縣,111597008,61,0.7988,28102129,1386,0.2012,139699137
2014年10月,新竹縣,511548322,219,0.9042,54185107,1509,0.0958,565733429
2014年10月,苗栗縣,409665164,145,0.909,40999727,1321,0.091,450664891
2014年10月,彰化縣,300766904,267,0.6183,185674577,16099,0.3817,486441481
2014年10月,南投縣,71618700,87,0.7058,29858696,1110,0.2942,101477396
2014年10月,雲林縣,198577164,82,0.8315,40233874,2397,0.1685,238811038
2014年10月,嘉義縣,40505400,56,0.5132,38418091,2089,0.4868,78923491
2014年10月,屏東縣,56608631,111,0.6077,36547362,1826,0.3923,93155993
2014年10月,台東縣,8096200,3,0.7857,2208227,370,0.2143,10304427
2014年10月,花蓮縣,78453900,20,0.8488,13972497,579,0.1512,92426397
2014年10月,基隆市,12324300,18,0.592,8492365,384,0.408,20816665
2014年10月,新竹市,652122619,128,0.9561,29950905,1723,0.0439,682073524
2014年10月,嘉義市,2590080,4,0.3123,5704547,661,0.6877,8294627
2014年10月,澎湖縣,1443200,1,0.3875,2280912,272,0.6125,3724112
2014年10月,金門縣,1536800,2,0.5146,1449850,184,0.4854,2986650
2014年10月,連江縣,0,0,0,501744,58,1,501744
2014年10月,合計,7593408082,3557,0.8208,1658005083,83688,0.1792,9251413165
2014年09月,新北市,217666601,230,0.4612,254336212,14431,0.5388,472002813
2014年09月,台北市,23738880,24,0.5417,20087779,1761,0.4583,43826659
2014年09月,桃園市,1381216237,767,0.8365,269980302,7030,0.1635,1651196539
2014年09月,台中市,885423118,393,0.7863,240598957,10991,0.2137,1126022075
2014年09月,台南市,1346910017,431,0.8699,201470103,11172,0.1301,1548380120
2014年09月,高雄市,1131529845,509,0.8741,163022924,6351,0.1259,1294552769
2014年09月,宜蘭縣,103771380,62,0.7786,29511013,1384,0.2214,133282393
2014年09月,新竹縣,518220217,218,0.901,56912214,1519,0.099,575132431
2014年09月,苗栗縣,402320600,146,0.9086,40447788,1317,0.0914,442768388
2014年09月,彰化縣,295773344,269,0.6153,184947114,16095,0.3847,480720458
2014年09月,南投縣,71367940,86,0.708,29435798,1112,0.292,100803738
2014年09月,雲林縣,194957440,81,0.8288,40270584,2399,0.1712,235228024
2014年09月,嘉義縣,40133880,57,0.5161,37629201,2086,0.4839,77763081
2014年09月,屏東縣,53149983,111,0.5954,36121456,1822,0.4046,89271439
2014年09月,台東縣,7647800,3,0.7712,2268962,366,0.2288,9916762
2014年09月,花蓮縣,74121000,20,0.8508,12993712,579,0.1492,87114712
2014年09月,基隆市,11921647,18,0.5647,9188783,385,0.4353,21110430
2014年09月,新竹市,667930042,130,0.9551,31412443,1728,0.0449,699342485
2014年09月,嘉義市,2549360,4,0.3016,5904005,662,0.6984,8453365
2014年09月,澎湖縣,1454400,1,0.3753,2420677,272,0.6247,3875077
2014年09月,金門縣,1876000,2,0.5367,1619624,183,0.4633,3495624
2014年09月,連江縣,0,0,0,513335,58,1,513335
2014年09月,合計,7433679731,3562,0.8165,1671092986,83703,0.1835,9104772717
2014年08月,新北市,227137232,226,0.4555,271499467,14435,0.5445,498636699
2014年08月,台北市,25703760,25,0.5511,20939763,1769,0.4489,46643523
2014年08月,桃園市,1437885443,768,0.8349,284314591,7012,0.1651,1722200034
2014年08月,台中市,954596415,391,0.7899,253935792,10980,0.2101,1208532207
2014年08月,台南市,1399851776,431,0.8672,214310734,11174,0.1328,1614162510
2014年08月,高雄市,1194240043,509,0.8754,170027384,6331,0.1246,1364267427
2014年08月,宜蘭縣,115191660,60,0.785,31554298,1385,0.215,146745958
2014年08月,新竹縣,537320236,217,0.9006,59272542,1517,0.0994,596592778
2014年08月,苗栗縣,412255156,146,0.9063,42633739,1318,0.0937,454888895
2014年08月,彰化縣,311744620,267,0.6131,196741523,16094,0.3869,508486143
2014年08月,南投縣,73020860,86,0.7025,30929896,1112,0.2975,103950756
2014年08月,雲林縣,201486732,82,0.8245,42881701,2396,0.1755,244368433
2014年08月,嘉義縣,42487300,57,0.5146,40073667,2088,0.4854,82560967
2014年08月,屏東縣,56072054,111,0.5958,38038781,1825,0.4042,94110835
2014年08月,台東縣,8066500,3,0.7598,2549716,366,0.2402,10616216
2014年08月,花蓮縣,78551600,21,0.851,13749327,582,0.149,92300927
2014年08月,基隆市,13028700,18,0.5757,9603743,386,0.4243,22632443
2014年08月,新竹市,693242917,131,0.9546,33003091,1726,0.0454,726246008
2014年08月,嘉義市,2589680,4,0.2915,6294333,662,0.7085,8884013
2014年08月,澎湖縣,1662000,1,0.3924,2573916,272,0.6076,4235916
2014年08月,金門縣,2012400,2,0.5456,1676083,183,0.4544,3688483
2014年08月,連江縣,0,0,0,612069,60,1,612069
2014年08月,合計,7788147084,3556,0.8151,1767216156,83673,0.1849,9555363240
2014年07月,新北市,232798215,225,0.4815,250645956,14418,0.5185,483444171
2014年07月,台北市,26096520,24,0.5828,18681710,1777,0.4172,44778230
2014年07月,桃園市,1441448461,767,0.8388,276968794,7000,0.1612,1718417255
2014年07月,台中市,954564456,391,0.7945,246953156,10970,0.2055,1201517612
2014年07月,台南市,1414929806,432,0.8708,209906988,11166,0.1292,1624836794
2014年07月,高雄市,1200746350,507,0.877,168481222,6330,0.123,1369227572
2014年07月,宜蘭縣,114547434,61,0.7916,30165020,1382,0.2084,144712454
2014年07月,新竹縣,545836094,218,0.9058,56754789,1517,0.0942,602590883
2014年07月,苗栗縣,418733264,146,0.9102,41324418,1313,0.0898,460057682
2014年07月,彰化縣,307674268,264,0.6213,187539230,16087,0.3787,495213498
2014年07月,南投縣,74531600,86,0.7086,30647828,1111,0.2914,105179428
2014年07月,雲林縣,198658972,82,0.8271,41518401,2394,0.1729,240177373
2014年07月,嘉義縣,43447740,57,0.5262,39119444,2092,0.4738,82567184
2014年07月,屏東縣,59789264,111,0.6159,37284662,1824,0.3841,97073926
2014年07月,台東縣,8123900,3,0.7808,2280388,367,0.2192,10404288
2014年07月,花蓮縣,81796200,21,0.8594,13382814,582,0.1406,95179014
2014年07月,基隆市,12874949,18,0.5885,9003143,387,0.4115,21878092
2014年07月,新竹市,695514411,130,0.9571,31177353,1727,0.0429,726691764
2014年07月,嘉義市,2616720,4,0.3135,5729522,662,0.6865,8346242
2014年07月,澎湖縣,1547200,1,0.3885,2435690,272,0.6115,3982890
2014年07月,金門縣,2072400,2,0.5676,1578459,181,0.4324,3650859
2014年07月,連江縣,0,0,0,593827,60,1,593827
2014年07月,合計,7838348224,3550,0.8216,1702172814,83619,0.1784,9540521038
2014年06月,合計,7702709227,3531,0.8267,1614237168,83569,0.1733,9316946395
2014年06月,新北市,213235853,224,0.4741,236546671,14379,0.5259,449782524
2014年06月,台北市,23896620,24,0.5765,17552443,1787,0.4235,41449063
2014年06月,桃園市,1354492196,763,0.8379,262059092,6974,0.1621,1616551288
2014年06月,台中市,911778694,390,0.7968,232525342,10967,0.2032,1144304036
2014年06月,台南市,1341453518,432,0.8702,200043855,11166,0.1298,1541497373
2014年06月,高雄市,1173860928,503,0.8793,161074322,6337,0.1207,1334935250
2014年06月,宜蘭縣,106426214,61,0.7938,27637194,1376,0.2062,134063408
2014年06月,新竹縣,514345459,217,0.9062,53232454,1513,0.0938,567577913
2014年06月,苗栗縣,401647348,144,0.9111,39180036,1311,0.0889,440827384
2014年06月,彰化縣,294442600,262,0.6211,179628227,16102,0.3789,474070827
2014年06月,南投縣,69188040,86,0.7103,28212180,1110,0.2897,97400220
2014年06月,雲林縣,190347997,83,0.827,39814342,2388,0.173,230162339
2014年06月,嘉義縣,40528580,55,0.5099,38958654,2097,0.4901,79487234
2014年06月,屏東縣,85917788,112,0.7102,35058985,1826,0.2898,120976773
2014年06月,台東縣,7748900,3,0.7904,2054763,368,0.2096,9803663
2014年06月,花蓮縣,76812100,21,0.8571,12811592,585,0.1429,89623692
2014年06月,基隆市,12266500,18,0.5962,8308430,384,0.4038,20574930
2014年06月,新竹市,665520094,130,0.958,29154900,1728,0.042,694674994
2014年06月,嘉義市,2521040,4,0.3123,5552657,663,0.6877,8073697
2014年06月,澎湖縣,1544000,1,0.4052,2266375,272,0.5948,3810375
2014年06月,金門縣,1763200,2,0.5455,1469124,181,0.4545,3232324
2014年06月,連江縣,0,0,0,483819,60,1,483819
2014年06月,合計,7489737669,3535,0.8227,1613625457,83574,0.1773,9103363126
2014年05月,新北市,218268185,224,0.4873,229684584,14389,0.5127,447952769
2014年05月,台北市,24094300,23,0.5907,16694529,1797,0.4093,40788829
2014年05月,桃園市,1394687868,760,0.8405,264727198,6956,0.1595,1659415066
2014年05月,台中市,954369565,391,0.8043,232162407,10962,0.1957,1186531972
2014年05月,台南市,1357321736,430,0.8703,202307028,11178,0.1297,1559628764
2014年05月,高雄市,1210289976,501,0.8794,166012367,6333,0.1206,1376302343
2014年05月,宜蘭縣,112965993,62,0.8047,27411616,1375,0.1953,140377609
2014年05月,新竹縣,520327643,215,0.9095,51780641,1508,0.0905,572108284
2014年05月,苗栗縣,424963560,145,0.9147,39652510,1311,0.0853,464616070
2014年05月,彰化縣,309065596,263,0.6316,180248846,16099,0.3684,489314442
2014年05月,南投縣,72273880,86,0.7143,28909413,1109,0.2857,101183293
2014年05月,雲林縣,200251719,84,0.8392,38370741,2384,0.1608,238622460
2014年05月,嘉義縣,42102800,56,0.509,40605863,2096,0.491,82708663
2014年05月,屏東縣,87930937,112,0.7125,35475295,1826,0.2875,123406232
2014年05月,台東縣,7915400,3,0.8061,1903735,368,0.1939,9819135
2014年05月,花蓮縣,81269700,21,0.8585,13396736,584,0.1415,94666436
2014年05月,基隆市,12105100,18,0.6041,7934431,383,0.3959,20039531
2014年05月,新竹市,666556709,130,0.9602,27644887,1734,0.0398,694201596
2014年05月,嘉義市,2652560,4,0.3336,5299379,664,0.6664,7951939
2014年05月,澎湖縣,1709200,1,0.4323,2244373,272,0.5677,3953573
2014年05月,金門縣,1586800,2,0.5452,1323536,181,0.4548,2910336
2014年05月,連江縣,0,0,0,447053,60,1,447053
2014年04月,新北市,206732633,224,0.4917,213754309,14387,0.5083,420486942
2014年04月,台北市,22342900,23,0.5985,14985978,1791,0.4015,37328878
2014年04月,桃園市,1313820606,756,0.841,248395323,6936,0.159,1562215929
2014年04月,台中市,897611636,390,0.8038,219100240,10959,0.1962,1116711876
2014年04月,台南市,1349748400,431,0.8763,190564447,11168,0.1237,1540312847
2014年04月,高雄市,1158132244,502,0.882,154919279,6329,0.118,1313051523
2014年04月,宜蘭縣,112910100,64,0.8204,24713664,1365,0.1796,137623764
2014年04月,新竹縣,483855614,214,0.9012,53016438,1505,0.0988,536872052
2014年04月,苗栗縣,396384620,144,0.9127,37893534,1316,0.0873,434278154
2014年04月,彰化縣,294256872,265,0.63,172814493,16105,0.37,467071365
2014年04月,南投縣,68760920,87,0.7135,27615137,1108,0.2865,96376057
2014年04月,雲林縣,188269140,82,0.837,36661021,2385,0.163,224930161
2014年04月,嘉義縣,38843360,56,0.4782,42389257,2095,0.5218,81232617
2014年04月,屏東縣,61338708,111,0.6504,32964285,1832,0.3496,94302993
2014年04月,台東縣,7706900,3,0.8033,1887437,366,0.1967,9594337
2014年04月,花蓮縣,78631000,21,0.8552,13317196,587,0.1448,91948196
2014年04月,基隆市,11438600,19,0.6154,7147171,385,0.3846,18585771
2014年04月,新竹市,616408944,130,0.9603,25511202,1740,0.0397,641920146
2014年04月,嘉義市,2536000,4,0.3385,4955902,664,0.6615,7491902
2014年04月,澎湖縣,1288400,1,0.3896,2018250,272,0.6104,3306650
2014年04月,金門縣,770000,2,0.3742,1287793,182,0.6258,2057793
2014年04月,連江縣,0,0,0,431424,60,1,431424
2014年04月,合計,7311787597,3529,0.8273,1526343780,83537,0.1727,8838131377
2014年03月,新北市,205331665,222,0.5132,194745506,14392,0.4868,400077171
2014年03月,台北市,22094300,24,0.628,13087694,1790,0.372,35181994
2014年03月,桃園市,1306573454,756,0.8456,238504548,6931,0.1544,1545078002
2014年03月,台中市,900531585,388,0.8134,206649669,10964,0.1866,1107181254
2014年03月,台南市,1260534039,427,0.8749,180167915,11169,0.1251,1440701954
2014年03月,高雄市,1209494646,501,0.8871,153891225,6314,0.1129,1363385871
2014年03月,宜蘭縣,117354260,64,0.8317,23748053,1361,0.1683,141102313
2014年03月,新竹縣,482087518,213,0.9159,44294689,1501,0.0841,526382207
2014年03月,苗栗縣,405260240,144,0.9189,35769090,1319,0.0811,441029330
2014年03月,彰化縣,296873716,262,0.6456,162954580,16126,0.3544,459828296
2014年03月,南投縣,68431060,88,0.7161,27127555,1107,0.2839,95558615
2014年03月,雲林縣,194283680,83,0.8506,34134136,2384,0.1494,228417816
2014年03月,嘉義縣,38523540,55,0.5226,35189023,2098,0.4774,73712563
2014年03月,屏東縣,56974033,112,0.6554,29953470,1829,0.3446,86927503
2014年03月,台東縣,8325800,3,0.8247,1769833,369,0.1753,10095633
2014年03月,花蓮縣,79800300,20,0.8574,13274924,589,0.1426,93075224
2014年03月,基隆市,11894500,19,0.6403,6681154,388,0.3597,18575654
2014年03月,新竹市,621087031,130,0.9641,23153367,1732,0.0359,644240398
2014年03月,嘉義市,2458160,4,0.3573,4422541,664,0.6427,6880701
2014年03月,澎湖縣,1459200,1,0.4275,1953964,272,0.5725,3413164
2014年03月,金門縣,703200,2,0.3908,1096224,184,0.6092,1799424
2014年03月,連江縣,0,0,0,428880,59,1,428880
2014年03月,合計,7290075927,3518,0.8357,1432998040,83542,0.1643,8723073967
2014年02月,新北市,166095434,223,0.4878,174430010,14380,0.5122,340525444
2014年02月,台北市,18701000,24,0.5954,12710056,1801,0.4046,31411056
2014年02月,桃園市,1115499705,754,0.847,201489460,6936,0.153,1316989165
2014年02月,台中市,764396160,387,0.8135,175194065,10959,0.1865,939590225
2014年02月,台南市,1088253391,429,0.8713,160707710,11160,0.1287,1248961101
2014年02月,高雄市,1089485263,500,0.8985,123054915,6317,0.1015,1212540178
2014年02月,宜蘭縣,88113200,64,0.8153,19961988,1361,0.1847,108075188
2014年02月,新竹縣,412030199,213,0.8949,48414318,1497,0.1051,460444517
2014年02月,苗栗縣,348327440,144,0.9166,31693132,1322,0.0834,380020572
2014年02月,彰化縣,242976024,262,0.6306,142344818,16130,0.3694,385320842
2014年02月,南投縣,55696860,88,0.7054,23265502,1107,0.2946,78962362
2014年02月,雲林縣,166069280,84,0.8497,29376013,2382,0.1503,195445293
2014年02月,嘉義縣,30702720,57,0.502,30453344,2094,0.498,61156064
2014年02月,屏東縣,45343520,109,0.6324,26360139,1833,0.3676,71703659
2014年02月,台東縣,6334000,3,0.7877,1706738,369,0.2123,8040738
2014年02月,花蓮縣,69208500,20,0.8455,12645849,592,0.1545,81854349
2014年02月,基隆市,9559600,19,0.6094,6128358,389,0.3906,15687958
2014年02月,新竹市,548645592,130,0.9633,20876479,1739,0.0367,569522071
2014年02月,嘉義市,1868760,4,0.3116,4129194,663,0.6884,5997954
2014年02月,澎湖縣,1417600,1,0.4337,1850724,271,0.5663,3268324
2014年02月,金門縣,578400,2,0.3501,1073682,184,0.6499,1652082
2014年02月,連江縣,0,0,0,413304,59,1,413304
2014年02月,合計,6269302648,3517,0.834,1248279798,83545,0.166,7517582446
2014年01月,新北市,189934887,223,0.4822,203979547,14380,0.5178,393914434
2014年01月,台北市,21471580,24,0.5955,14583543,1803,0.4045,36055123
2014年01月,桃園市,1229086909,757,0.8375,238551402,6921,0.1625,1467638311
2014年01月,台中市,861195146,387,0.8112,200412223,10965,0.1888,1061607369
2014年01月,台南市,1202463753,432,0.8724,175845375,11154,0.1276,1378309128
2014年01月,高雄市,1211524306,498,0.8974,138467920,6315,0.1026,1349992226
2014年01月,宜蘭縣,107336640,64,0.82,23569011,1363,0.18,130905651
2014年01月,新竹縣,458825094,214,0.9115,44545527,1491,0.0885,503370621
2014年01月,苗栗縣,386690580,143,0.9153,35774465,1325,0.0847,422465045
2014年01月,彰化縣,281502790,262,0.6268,167602847,16143,0.3732,449105637
2014年01月,南投縣,61148820,88,0.7005,26139780,1104,0.2995,87288600
2014年01月,雲林縣,185838400,84,0.8477,33381160,2380,0.1523,219219560
2014年01月,嘉義縣,34914280,57,0.5069,33957994,2091,0.4931,68872274
2014年01月,屏東縣,50573232,108,0.6233,30560103,1838,0.3767,81133335
2014年01月,台東縣,7226800,3,0.7855,1973953,370,0.2145,9200753
2014年01月,花蓮縣,85689300,20,0.8738,12376103,591,0.1262,98065403
2014年01月,基隆市,11412900,19,0.6237,6884414,389,0.3763,18297314
2014年01月,新竹市,597247759,130,0.9621,23502637,1745,0.0379,620750396
2014年01月,嘉義市,2260600,4,0.3214,4772772,662,0.6786,7033372
2014年01月,澎湖縣,1424400,1,0.4131,2023837,271,0.5869,3448237
2014年01月,金門縣,662400,2,0.3421,1273719,181,0.6579,1936119
2014年01月,連江縣,0,0,0,423790,59,1,423790
2014年01月,合計,6988430576,3520,0.8311,1420602122,83541,0.1689,8409032698
2013年12月,新北市,201215653,223,0.4915,208181136,14383,0.5085,409396789
2013年12月,台北市,21645020,23,0.5953,14717737,1804,0.4047,36362757
2013年12月,桃園市,1272881864,754,0.8422,238520028,6907,0.1578,1511401892
2013年12月,台中市,872820680,388,0.8066,209304723,10954,0.1934,1082125403
2013年12月,台南市,1210328301,427,0.8678,184425484,11171,0.1322,1394753785
2013年12月,高雄市,1204182753,499,0.8908,147639787,6309,0.1092,1351822540
2013年12月,宜蘭縣,112344220,64,0.8251,23819456,1360,0.1749,136163676
2013年12月,新竹縣,464367662,214,0.9105,45665422,1493,0.0895,510033084
2013年12月,苗栗縣,391575466,141,0.9122,37672412,1326,0.0878,429247878
2013年12月,彰化縣,287799307,262,0.6298,169173536,16151,0.3702,456972843
2013年12月,南投縣,62569000,88,0.6965,27268339,1106,0.3035,89837339
2013年12月,雲林縣,186918020,85,0.8445,34410055,2379,0.1555,221328075
2013年12月,嘉義縣,36444800,56,0.5027,36047274,2097,0.4973,72492074
2013年12月,屏東縣,53100304,107,0.6295,31258681,1842,0.3705,84358985
2013年12月,台東縣,7898300,3,0.8064,1896061,373,0.1936,9794361
2013年12月,花蓮縣,78798300,20,0.8576,13087125,591,0.1424,91885425
2013年12月,基隆市,11253100,19,0.6169,6989511,389,0.3831,18242611
2013年12月,新竹市,600130961,130,0.9613,24184538,1748,0.0387,624315499
2013年12月,嘉義市,2444680,4,0.3441,4660869,664,0.6559,7105549
2013年12月,澎湖縣,1402800,1,0.4179,1953987,270,0.5821,3356787
2013年12月,金門縣,706000,2,0.3529,1294672,183,0.6471,2000672
2013年12月,連江縣,0,0,0,423926,59,1,423926
2013年12月,合計,7080827191,3510,0.8288,1462594759,83559,0.1712,8543421950
2013年11月,新北市,204270406,225,0.4791,222069923,14385,0.5209,426340329
2013年11月,台北市,21889940,24,0.5706,16475311,1804,0.4294,38365251
2013年11月,桃園市,1253140017,750,0.8381,242034505,6904,0.1619,1495174522
2013年11月,台中市,875573550,383,0.802,216137865,10940,0.198,1091711415
2013年11月,台南市,1203330257,427,0.8616,193348833,11165,0.1384,1396679090
2013年11月,高雄市,1181568452,498,0.8822,157732273,6291,0.1178,1339300725
2013年11月,宜蘭縣,107940720,65,0.8162,24313395,1354,0.1838,132254115
2013年11月,新竹縣,467390303,214,0.9075,47620579,1494,0.0925,515010882
2013年11月,苗栗縣,384113520,142,0.9095,38240116,1325,0.0905,422353636
2013年11月,彰化縣,279396316,261,0.6166,173735452,16147,0.3834,453131768
2013年11月,南投縣,61438260,88,0.6892,27708642,1108,0.3108,89146902
2013年11月,雲林縣,187356080,86,0.8424,35057791,2383,0.1576,222413871
2013年11月,嘉義縣,37343060,57,0.4997,37389226,2092,0.5003,74732286
2013年11月,屏東縣,53041720,107,0.6191,32630383,1846,0.3809,85672103
2013年11月,台東縣,7708300,3,0.7975,1957223,372,0.2025,9665523
2013年11月,花蓮縣,88738400,20,0.8709,13159634,590,0.1291,101898034
2013年11月,基隆市,11534800,19,0.6047,7541084,388,0.3953,19075884
2013年11月,新竹市,596458768,130,0.9579,26190364,1752,0.0421,622649132
2013年11月,嘉義市,2367640,4,0.323,4961562,664,0.677,7329202
2013年11月,澎湖縣,1401200,1,0.401,2093221,271,0.599,3494421
2013年11月,金門縣,895600,2,0.4084,1297538,181,0.5916,2193138
2013年11月,連江縣,0,0,0,427820,59,1,427820
2013年11月,合計,7026897309,3506,0.822,1522122740,83515,0.178,8549020049
2013年10月,新北市,215191959,226,0.4808,232333874,14361,0.5192,447525833
2013年10月,台北市,22644580,23,0.5594,17836918,1804,0.4406,40481498
2013年10月,桃園市,1350867500,745,0.8399,257451272,6895,0.1601,1608318772
2013年10月,台中市,919841886,383,0.8047,223292083,10919,0.1953,1143133969
2013年10月,台南市,1261662129,427,0.8632,199894608,11161,0.1368,1461556737
2013年10月,高雄市,1248561344,497,0.8881,157330273,6290,0.1119,1405891617
2013年10月,宜蘭縣,112178920,65,0.8165,25218888,1347,0.1835,137397808
2013年10月,新竹縣,502670682,211,0.9079,50991162,1491,0.0921,553661844
2013年10月,苗栗縣,391903060,142,0.9084,39503871,1325,0.0916,431406931
2013年10月,彰化縣,301571997,260,0.6282,178491993,16155,0.3718,480063990
2013年10月,南投縣,68206160,89,0.7054,28484128,1109,0.2946,96690288
2013年10月,雲林縣,198217760,85,0.843,36903362,2392,0.157,235121122
2013年10月,嘉義縣,40125440,56,0.5188,37219036,2087,0.4812,77344476
2013年10月,屏東縣,54062608,107,0.6163,33660197,1847,0.3837,87722805
2013年10月,台東縣,7883600,3,0.7936,2050263,371,0.2064,9933863
2013年10月,花蓮縣,81503000,20,0.8634,12892501,587,0.1366,94395501
2013年10月,基隆市,12115800,19,0.6035,7960207,391,0.3965,20076007
2013年10月,新竹市,627465946,129,0.9558,28990328,1750,0.0442,656456274
2013年10月,嘉義市,2585920,4,0.3305,5238729,665,0.6695,7824649
2013年10月,澎湖縣,1402000,1,0.3897,2195538,272,0.6103,3597538
2013年10月,金門縣,1648000,2,0.5429,1387492,179,0.4571,3035492
2013年10月,連江縣,0,0,0,463897,59,1,463897
2013年10月,合計,7422310291,3494,0.8245,1579790620,83457,0.1755,9002100911
2013年09月,新北市,213447733,226,0.4654,245181712,14346,0.5346,458629445
2013年09月,台北市,22901020,24,0.5347,19931540,1815,0.4653,42832560
2013年09月,桃園市,1334667976,746,0.8367,260462458,6891,0.1633,1595130434
2013年09月,台中市,879569437,382,0.798,222655119,10920,0.202,1102224556
2013年09月,台南市,1219043473,426,0.8601,198237086,11165,0.1399,1417280559
2013年09月,高雄市,1184779627,495,0.8847,154352240,6280,0.1153,1339131867
2013年09月,宜蘭縣,108333840,65,0.8012,26885072,1345,0.1988,135218912
2013年09月,新竹縣,497449643,212,0.9056,51853901,1481,0.0944,549303544
2013年09月,苗栗縣,395568020,142,0.9095,39338944,1319,0.0905,434906964
2013年09月,彰化縣,295972225,260,0.625,177621126,16156,0.375,473593351
2013年09月,南投縣,63994480,88,0.6999,27445372,1108,0.3001,91439852
2013年09月,雲林縣,191611605,85,0.8414,36122295,2391,0.1586,227733900
2013年09月,嘉義縣,39503820,57,0.5074,38351659,2085,0.4926,77855479
2013年09月,屏東縣,51746534,108,0.6082,33337082,1846,0.3918,85083616
2013年09月,台東縣,7845800,3,0.7951,2021680,373,0.2049,9867480
2013年09月,花蓮縣,81447000,19,0.862,13035081,588,0.138,94482081
2013年09月,基隆市,11360900,19,0.5803,8218190,390,0.4197,19579090
2013年09月,新竹市,626750935,129,0.9546,29800187,1747,0.0454,656551122
2013年09月,嘉義市,2364400,4,0.2988,5547440,665,0.7012,7911840
2013年09月,澎湖縣,1301600,1,0.3528,2388069,272,0.6472,3689669
2013年09月,金門縣,1732400,2,0.5388,1483149,178,0.4612,3215549
2013年09月,連江縣,0,0,0,495915,59,1,495915
2013年09月,合計,7231392468,3493,0.8193,1594765317,83420,0.1807,8826157785
2013年08月,新北市,228184622,226,0.4738,253401336,14354,0.5262,481585958
2013年08月,台北市,24182200,24,0.5362,20912934,1834,0.4638,45095134
2013年08月,桃園市,1415917532,744,0.8356,278574542,6884,0.1644,1694492074
2013年08月,台中市,946729382,383,0.7995,237487518,10912,0.2005,1184216900
2013年08月,台南市,1271007691,426,0.8582,209981036,11181,0.1418,1480988727
2013年08月,高雄市,1228745289,491,0.8816,165027558,6285,0.1184,1393772847
2013年08月,宜蘭縣,111958560,66,0.7987,28223486,1343,0.2013,140182046
2013年08月,新竹縣,526935039,211,0.9042,55833322,1485,0.0958,582768361
2013年08月,苗栗縣,411011740,142,0.9091,41114832,1321,0.0909,452126572
2013年08月,彰化縣,313682132,258,0.6283,185586543,16170,0.3717,499268675
2013年08月,南投縣,69523700,87,0.7026,29429712,1105,0.2974,98953412
2013年08月,雲林縣,199399703,86,0.8403,37894808,2394,0.1597,237294511
2013年08月,嘉義縣,42682280,58,0.5176,39777289,2087,0.4824,82459569
2013年08月,屏東縣,55187672,108,0.6127,34882738,1845,0.3873,90070410
2013年08月,台東縣,8313500,3,0.7943,2153512,372,0.2057,10467012
2013年08月,花蓮縣,85474200,19,0.8588,14048646,589,0.1412,99522846
2013年08月,基隆市,11930600,18,0.5794,8659231,393,0.4206,20589831
2013年08月,新竹市,658382067,129,0.9547,31232901,1748,0.0453,689614968
2013年08月,嘉義市,2446400,4,0.3062,5544331,663,0.6938,7990731
2013年08月,澎湖縣,1324400,1,0.3446,2518607,272,0.6554,3843007
2013年08月,金門縣,2016800,2,0.5634,1562852,177,0.4366,3579652
2013年08月,連江縣,0,0,0,477083,59,1,477083
2013年08月,合計,7615035509,3486,0.8189,1684324817,83473,0.1811,9299360326
2013年07月,新北市,230674234,226,0.4739,256118206,14358,0.5261,486792440
2013年07月,台北市,24702980,23,0.5372,21279694,1839,0.4628,45982674
2013年07月,桃園市,1400428525,746,0.8339,278921058,6869,0.1661,1679349583
2013年07月,台中市,932144519,381,0.7934,242719268,10918,0.2066,1174863787
2013年07月,台南市,1260026966,425,0.8549,213877620,11188,0.1451,1473904586
2013年07月,高雄市,1197442868,493,0.877,167918375,6271,0.123,1365361243
2013年07月,宜蘭縣,110256640,63,0.7971,28068858,1338,0.2029,138325498
2013年07月,新竹縣,525223478,212,0.9021,57014886,1477,0.0979,582238364
2013年07月,苗栗縣,392791020,140,0.9041,41650308,1323,0.0959,434441328
2013年07月,彰化縣,306726120,256,0.6206,187494828,16173,0.3794,494220948
2013年07月,南投縣,68482420,88,0.7026,28983544,1103,0.2974,97465964
2013年07月,雲林縣,196844960,85,0.8359,38634446,2394,0.1641,235479406
2013年07月,嘉義縣,42856262,58,0.4965,43452595,2090,0.5035,86308857
2013年07月,屏東縣,56075364,108,0.6086,36069028,1848,0.3914,92144392
2013年07月,台東縣,8179400,3,0.7829,2268564,371,0.2171,10447964
2013年07月,花蓮縣,75652900,19,0.8451,13864115,589,0.1549,89517015
2013年07月,基隆市,11480848,18,0.5655,8821783,391,0.4345,20302631
2013年07月,新竹市,657086096,129,0.9543,31455844,1759,0.0457,688541940
2013年07月,嘉義市,2433520,4,0.3003,5671260,662,0.6997,8104780
2013年07月,澎湖縣,1288800,1,0.3389,2514453,277,0.6611,3803253
2013年07月,金門縣,2011600,2,0.5748,1488021,177,0.4252,3499621
2013年07月,連江縣,0,0,0,543771,59,1,543771
2013年07月,合計,7502809520,3480,0.8145,1708830525,83474,0.1855,9211640045
2013年06月,合計,7583367829,3477,0.8241,1618365361,83421,0.1759,9201733190
2013年06月,新北市,230133303,225,0.4913,238313363,14343,0.5087,468446666
2013年06月,台北市,25404540,23,0.5687,19263604,1830,0.4313,44668144
2013年06月,桃園市,1463396293,746,0.8412,276171884,6856,0.1588,1739568177
2013年06月,台中市,982169316,384,0.8054,237365149,10901,0.1946,1219534465
2013年06月,台南市,1290175121,423,0.862,206506055,11193,0.138,1496681176
2013年06月,高雄市,1263710999,494,0.8859,162769523,6267,0.1141,1426480522
2013年06月,宜蘭縣,107625960,65,0.8034,26337935,1331,0.1966,133963895
2013年06月,新竹縣,548545917,212,0.9067,56419998,1468,0.0933,604965915
2013年06月,苗栗縣,424231880,140,0.9093,42290631,1321,0.0907,466522511
2013年06月,彰化縣,322682696,257,0.6386,182583332,16189,0.3614,505266028
2013年06月,南投縣,71456360,88,0.7112,29016816,1104,0.2888,100473176
2013年06月,雲林縣,196342920,84,0.8402,37351920,2395,0.1598,233694840
2013年06月,嘉義縣,43334032,58,0.5258,39086365,2086,0.4742,82420397
2013年06月,屏東縣,56916760,109,0.6262,33976367,1850,0.3738,90893127
2013年06月,台東縣,8861300,3,0.8066,2124141,371,0.1934,10985441
2013年06月,花蓮縣,87336400,19,0.8621,13967590,589,0.1379,101303990
2013年06月,基隆市,12492100,18,0.6061,8119401,391,0.3939,20611501
2013年06月,新竹市,681883408,130,0.9573,30421070,1762,0.0427,712304478
2013年06月,嘉義市,2501720,4,0.3218,5272062,662,0.6782,7773782
2013年06月,澎湖縣,1373200,1,0.3625,2415219,278,0.6375,3788419
2013年06月,金門縣,1866800,2,0.5593,1470700,176,0.4407,3337500
2013年06月,連江縣,0,0,0,510819,59,1,510819
2013年06月,合計,7822441025,3485,0.8257,1651753944,83422,0.1743,9474194969
2013年05月,新北市,226776612,224,0.4961,230350952,14337,0.5039,457127564
2013年05月,台北市,23852720,23,0.5698,18007618,1833,0.4302,41860338
2013年05月,桃園市,1402334562,745,0.839,269200444,6860,0.161,1671535006
2013年05月,台中市,997795768,387,0.813,229477367,10892,0.187,1227273135
2013年05月,台南市,1236694422,422,0.8584,204004944,11197,0.1416,1440699366
2013年05月,高雄市,1213893990,492,0.8803,165132160,6265,0.1197,1379026150
2013年05月,宜蘭縣,114463720,65,0.8199,25151371,1328,0.1801,139615091
2013年05月,新竹縣,524500366,210,0.9074,53515713,1470,0.0926,578016079
2013年05月,苗栗縣,406121015,142,0.9089,40722136,1322,0.0911,446843151
2013年05月,彰化縣,312468212,254,0.6314,182382108,16197,0.3686,494850320
2013年05月,南投縣,70400180,86,0.7073,29132114,1102,0.2927,99532294
2013年05月,雲林縣,192063712,84,0.8395,36719705,2401,0.1605,228783417
2013年05月,嘉義縣,41752112,59,0.5085,40362102,2081,0.4915,82114214
2013年05月,屏東縣,55045148,106,0.6188,33907609,1848,0.3812,88952757
2013年05月,台東縣,8063900,3,0.7931,2104262,371,0.2069,10168162
2013年05月,花蓮縣,91655180,19,0.8727,13365358,589,0.1273,105020538
2013年05月,基隆市,11604515,18,0.6004,7724228,388,0.3996,19328743
2013年05月,新竹市,648938535,131,0.9586,28005153,1764,0.0414,676943688
2013年05月,嘉義市,2602360,4,0.3392,5069763,664,0.6608,7672123
2013年05月,澎湖縣,1378400,1,0.3833,2217750,278,0.6167,3596150
2013年05月,金門縣,962400,2,0.4163,1349134,175,0.5837,2311534
2013年05月,連江縣,0,0,0,463370,59,1,463370
2013年04月,新北市,215289584,225,0.5147,203020732,14334,0.4853,418310316
2013年04月,台北市,22231720,24,0.5903,15427034,1847,0.4097,37658754
2013年04月,桃園市,1331696485,744,0.8481,238551572,6836,0.1519,1570248057
2013年04月,台中市,919979308,386,0.8192,202993332,10884,0.1808,1122972640
2013年04月,台南市,1224203326,420,0.8679,186373705,11208,0.1321,1410577031
2013年04月,高雄市,1227154577,491,0.8875,155494487,6258,0.1125,1382649064
2013年04月,宜蘭縣,119169627,66,0.8367,23250863,1327,0.1633,142420490
2013年04月,新竹縣,481520755,210,0.9131,45845982,1469,0.0869,527366737
2013年04月,苗栗縣,392128868,142,0.914,36879041,1320,0.086,429007909
2013年04月,彰化縣,277218192,253,0.6303,162585929,16201,0.3697,439804121
2013年04月,南投縣,64387360,86,0.7092,26404835,1104,0.2908,90792195
2013年04月,雲林縣,193021400,85,0.8521,33514936,2399,0.1479,226536336
2013年04月,嘉義縣,40892105,58,0.4062,59779901,2075,0.5938,100672006
2013年04月,屏東縣,54534104,106,0.6401,30668050,1850,0.3599,85202154
2013年04月,台東縣,9379000,3,0.8285,1941924,371,0.1715,11320924
2013年04月,花蓮縣,88906843,19,0.8776,12396072,592,0.1224,101302915
2013年04月,基隆市,10869000,17,0.6112,6913680,389,0.3888,17782680
2013年04月,新竹市,622477070,131,0.9631,23862470,1766,0.0369,646339540
2013年04月,嘉義市,2643440,4,0.3586,4727732,665,0.6414,7371172
2013年04月,澎湖縣,1441600,1,0.4201,1990179,278,0.5799,3431779
2013年04月,金門縣,754000,2,0.3956,1151896,176,0.6044,1905896
2013年04月,連江縣,0,0,0,408106,59,1,408106
2013年04月,合計,7299898364,3473,0.832,1474182458,83408,0.168,8774080822
2013年03月,新北市,202020891,225,0.5109,193379335,14344,0.4891,395400226
2013年03月,台北市,22078920,24,0.5918,15227962,1858,0.4082,37306882
2013年03月,桃園市,1268938766,744,0.8425,237165078,6834,0.1575,1506103844
2013年03月,台中市,883761241,390,0.8168,198252669,10886,0.1832,1082013910
2013年03月,台南市,1148297228,421,0.8621,183639837,11212,0.1379,1331937065
2013年03月,高雄市,1197578373,490,0.8937,142439534,6257,0.1063,1340017907
2013年03月,宜蘭縣,108706651,65,0.8238,23252016,1323,0.1762,131958667
2013年03月,新竹縣,464045636,210,0.9118,44913062,1465,0.0882,508958698
2013年03月,苗栗縣,403048779,142,0.9197,35188287,1319,0.0803,438237066
2013年03月,彰化縣,289624988,252,0.6437,160325093,16212,0.3563,449950081
2013年03月,南投縣,62867280,85,0.6986,27127078,1106,0.3014,89994358
2013年03月,雲林縣,186756360,83,0.8513,32609803,2402,0.1487,219366163
2013年03月,嘉義縣,38922380,58,0.4985,39158287,2075,0.5015,78080667
2013年03月,屏東縣,52171148,105,0.6357,29896721,1852,0.3643,82067869
2013年03月,台東縣,8383800,3,0.8032,2054735,376,0.1968,10438535
2013年03月,花蓮縣,82698000,19,0.8711,12241587,595,0.1289,94939587
2013年03月,基隆市,10784284,17,0.6041,7067263,390,0.3959,17851547
2013年03月,新竹市,582624891,132,0.9625,22678148,1768,0.0375,605303039
2013年03月,嘉義市,2414880,4,0.3549,4390135,664,0.6451,6805015
2013年03月,澎湖縣,1378000,1,0.4115,1970917,278,0.5885,3348917
2013年03月,金門縣,679200,2,0.3818,1099745,177,0.6182,1778945
2013年03月,連江縣,0,0,0,422183,59,1,422183
2013年03月,合計,7017781696,3472,0.8323,1414499475,83452,0.1677,8432281171
2013年02月,新北市,150646226,224,0.4835,160898560,14350,0.5165,311544786
2013年02月,台北市,18252560,25,0.5827,13070807,1860,0.4173,31323367
2013年02月,桃園市,973960577,743,0.8391,186769673,6819,0.1609,1160730250
2013年02月,台中市,711689393,390,0.8262,149673955,10894,0.1738,861363348
2013年02月,台南市,954562693,419,0.8716,140614220,11212,0.1284,1095176913
2013年02月,高雄市,957876601,491,0.8986,108034614,6257,0.1014,1065911215
2013年02月,宜蘭縣,75892372,64,0.814,17342770,1327,0.186,93235142
2013年02月,新竹縣,388663379,210,0.9119,37526830,1469,0.0881,426190209
2013年02月,苗栗縣,311045402,143,0.9168,28211869,1319,0.0832,339257271
2013年02月,彰化縣,219916868,252,0.627,130805194,16215,0.373,350722062
2013年02月,南投縣,42592120,84,0.6805,19995537,1110,0.3195,62587657
2013年02月,雲林縣,152908000,82,0.8562,25687593,2400,0.1438,178595593
2013年02月,嘉義縣,28545420,60,0.4897,29750259,2075,0.5103,58295679
2013年02月,屏東縣,39797180,104,0.6256,23816907,1852,0.3744,63614087
2013年02月,台東縣,5657900,3,0.7536,1849891,376,0.2464,7507791
2013年02月,花蓮縣,70982856,19,0.8719,10428318,591,0.1281,81411174
2013年02月,基隆市,8194700,17,0.5843,5830376,388,0.4157,14025076
2013年02月,新竹市,510420262,132,0.964,19073561,1769,0.036,529493823
2013年02月,嘉義市,1763200,4,0.3098,3927476,666,0.6902,5690676
2013年02月,澎湖縣,1222400,1,0.4084,1770832,278,0.5916,2993232
2013年02月,金門縣,526400,2,0.3411,1016967,177,0.6589,1543367
2013年02月,連江縣,0,0,0,375988,59,1,375988
2013年02月,合計,5625116509,3469,0.8344,1116472197,83463,0.1656,6741588706
2013年01月,新北市,220050586,224,0.5147,207457450,14372,0.4853,427508036
2013年01月,台北市,23971620,25,0.6019,15853525,1876,0.3981,39825145
2013年01月,桃園市,1356143090,742,0.8394,259497855,6815,0.1606,1615640945
2013年01月,台中市,960817581,389,0.8219,208161160,10901,0.1781,1168978741
2013年01月,台南市,1239163655,421,0.8688,187129339,11217,0.1312,1426292994
2013年01月,高雄市,1274765909,490,0.8937,151549907,6260,0.1063,1426315816
2013年01月,宜蘭縣,122569314,64,0.834,24403828,1327,0.166,146973142
2013年01月,新竹縣,504779269,210,0.9111,49242239,1469,0.0889,554021508
2013年01月,苗栗縣,408423719,143,0.9136,38628125,1319,0.0864,447051844
2013年01月,彰化縣,316322428,253,0.6427,175853796,16204,0.3573,492176224
2013年01月,南投縣,64036300,83,0.6907,28669843,1110,0.3093,92706143
2013年01月,雲林縣,206111200,81,0.8558,34728222,2400,0.1442,240839422
2013年01月,嘉義縣,40749620,61,0.5328,35732340,2071,0.4672,76481960
2013年01月,屏東縣,55417502,104,0.6408,31064104,1856,0.3592,86481606
2013年01月,台東縣,9667600,3,0.8086,2288014,376,0.1914,11955614
2013年01月,花蓮縣,92791100,19,0.8754,13207019,594,0.1246,105998119
2013年01月,基隆市,11999443,17,0.6146,7523129,386,0.3854,19522572
2013年01月,新竹市,637535061,132,0.9646,23389602,1770,0.0354,660924663
2013年01月,嘉義市,2593280,4,0.3608,4594805,667,0.6392,7188085
2013年01月,澎湖縣,1576000,1,0.4316,2075137,278,0.5684,3651137
2013年01月,金門縣,747600,2,0.3791,1224416,179,0.6209,1972016
2013年01月,連江縣,0,0,0,456455,59,1,456455
2013年01月,合計,7550231877,3468,0.834,1502730310,83506,0.166,9052962187
2012年12月,新北市,187654348,224,0.4855,198854013,14382,0.5145,386508361
2012年12月,台北市,20228420,25,0.5631,15693299,1882,0.4369,35921719
2012年12月,桃園市,1140322751,745,0.8311,231751930,6812,0.1689,1372074681
2012年12月,台中市,814885987,389,0.812,188727330,10901,0.188,1003613317
2012年12月,台南市,1035610304,421,0.8564,173679822,11226,0.1436,1209290126
2012年12月,高雄市,1074006799,489,0.8828,142590235,6251,0.1172,1216597034
2012年12月,宜蘭縣,95984619,64,0.8174,21437371,1327,0.1826,117421990
2012年12月,新竹縣,419577849,209,0.9062,43444327,1472,0.0938,463022176
2012年12月,苗栗縣,333151878,141,0.9089,33397292,1320,0.0911,366549170
2012年12月,彰化縣,261545628,254,0.625,156956691,16206,0.375,418502319
2012年12月,南投縣,50919480,83,0.6675,25358672,1114,0.3325,76278152
2012年12月,雲林縣,166244500,80,0.8416,31300110,2403,0.1584,197544610
2012年12月,嘉義縣,35157940,61,0.4873,36994092,2073,0.5127,72152032
2012年12月,屏東縣,48050388,107,0.6342,27711650,1851,0.3658,75762038
2012年12月,台東縣,7904200,3,0.7849,2165606,375,0.2151,10069806
2012年12月,花蓮縣,72501600,19,0.8654,11272361,594,0.1346,83773961
2012年12月,基隆市,9490500,17,0.5826,6799650,388,0.4174,16290150
2012年12月,新竹市,529378018,132,0.9586,22859496,1772,0.0414,552237514
2012年12月,嘉義市,2195200,4,0.33,4456577,667,0.67,6651777
2012年12月,澎湖縣,1350000,1,0.4049,1984558,279,0.5951,3334558
2012年12月,金門縣,655600,2,0.3585,1173236,175,0.6415,1828836
2012年12月,連江縣,0,0,0,395157,59,1,395157
2012年12月,合計,6306816009,3470,0.8206,1379003475,83529,0.1794,7685819484
2012年11月,新北市,202346133,224,0.4771,221801397,14386,0.5229,424147530
2012年11月,台北市,22901960,25,0.5694,17321916,1883,0.4306,40223876
2012年11月,桃園市,1254391673,746,0.8348,248314018,6806,0.1652,1502705691
2012年11月,台中市,866443134,389,0.8073,206787962,10908,0.1927,1073231096
2012年11月,台南市,1140984635,419,0.8571,190220896,11242,0.1429,1331205531
2012年11月,高雄市,1190373875,490,0.8804,161703443,6243,0.1196,1352077318
2012年11月,宜蘭縣,101094940,64,0.8059,24349449,1326,0.1941,125444389
2012年11月,新竹縣,459903584,209,0.9071,47104758,1473,0.0929,507008342
2012年11月,苗栗縣,351343395,142,0.9069,36050038,1322,0.0931,387393433
2012年11月,彰化縣,280523331,255,0.6252,168150327,16225,0.3748,448673658
2012年11月,南投縣,58070660,82,0.6727,28257779,1118,0.3273,86328439
2012年11月,雲林縣,178682680,80,0.8395,34150372,2406,0.1605,212833052
2012年11月,嘉義縣,38440980,62,0.5143,36304797,2068,0.4857,74745777
2012年11月,屏東縣,54359734,105,0.6372,30946155,1853,0.3628,85305889
2012年11月,台東縣,8142200,3,0.7739,2378712,376,0.2261,10520912
2012年11月,花蓮縣,87932210,19,0.8739,12686571,593,0.1261,100618781
2012年11月,基隆市,11287350,18,0.5908,7817418,387,0.4092,19104768
2012年11月,新竹市,582034789,133,0.9589,24955841,1776,0.0411,606990630
2012年11月,嘉義市,2267800,4,0.316,4908881,668,0.684,7176681
2012年11月,澎湖縣,1434000,1,0.3998,2152789,280,0.6002,3586789
2012年11月,金門縣,915600,2,0.4179,1275588,175,0.5821,2191188
2012年11月,連江縣,0,0,0,363048,59,1,363048
2012年11月,合計,6893874663,3472,0.8205,1508002155,83573,0.1795,8401876818
2012年10月,新北市,227340037,227,0.4909,235799054,14366,0.5091,463139091
2012年10月,台北市,26134540,25,0.5805,18890045,1892,0.4195,45024585
2012年10月,桃園市,1385813466,749,0.843,258090550,6795,0.157,1643904016
2012年10月,台中市,948676554,389,0.8124,219028599,10902,0.1876,1167705153
2012年10月,台南市,1257726052,418,0.8651,196102513,11242,0.1349,1453828565
2012年10月,高雄市,1305900075,490,0.8874,165642480,6232,0.1126,1471542555
2012年10月,宜蘭縣,118075500,64,0.8245,25125524,1324,0.1755,143201024
2012年10月,新竹縣,516327393,207,0.9084,52041381,1467,0.0916,568368774
2012年10月,苗栗縣,396675959,142,0.9134,37622232,1317,0.0866,434298191
2012年10月,彰化縣,311543408,255,0.643,172984060,16230,0.357,484527468
2012年10月,南投縣,61493139,80,0.6741,29724087,1119,0.3259,91217226
2012年10月,雲林縣,201038160,81,0.8466,36425855,2402,0.1534,237464015
2012年10月,嘉義縣,41964860,62,0.5229,38285825,2070,0.4771,80250685
2012年10月,屏東縣,64426898,107,0.668,32014698,1846,0.332,96441596
2012年10月,台東縣,9468000,3,0.7976,2402650,376,0.2024,11870650
2012年10月,花蓮縣,92345600,19,0.8748,13216458,594,0.1252,105562058
2012年10月,基隆市,11538100,18,0.5806,8336139,383,0.4194,19874239
2012年10月,新竹市,648836762,132,0.9597,27242041,1776,0.0403,676078803
2012年10月,嘉義市,2176520,4,0.2849,5463246,670,0.7151,7639766
2012年10月,澎湖縣,1562800,1,0.4087,2260739,280,0.5913,3823539
2012年10月,金門縣,1540000,2,0.5155,1447252,175,0.4845,2987252
2012年10月,連江縣,0,0,0,437913,59,1,437913
2012年10月,合計,7630603823,3475,0.8286,1578583341,83517,0.1714,9209187164
2012年09月,新北市,202109020,227,0.4541,242926040,14376,0.5459,445035060
2012年09月,台北市,23765500,25,0.5401,20234554,1885,0.4599,44000054
2012年09月,桃園市,1238208262,747,0.8309,251994755,6779,0.1691,1490203017
2012年09月,台中市,804842888,390,0.7902,213661398,10908,0.2098,1018504286
2012年09月,台南市,1103905381,419,0.853,190243753,11249,0.147,1294149134
2012年09月,高雄市,1060190381,493,0.8786,146468299,6231,0.1214,1206658680
2012年09月,宜蘭縣,102760020,64,0.807,24568356,1322,0.193,127328376
2012年09月,新竹縣,470003033,210,0.9028,50599503,1457,0.0972,520602536
2012年09月,苗栗縣,336532818,142,0.9035,35933515,1317,0.0965,372466333
2012年09月,彰化縣,273643276,256,0.6208,167125782,16248,0.3792,440769058
2012年09月,南投縣,55480180,80,0.6703,27285870,1123,0.3297,82766050
2012年09月,雲林縣,175036620,82,0.8343,34769548,2402,0.1657,209806168
2012年09月,嘉義縣,38059060,61,0.4955,38748090,2072,0.5045,76807150
2012年09月,屏東縣,86530320,107,0.7417,30132584,1845,0.2583,116662904
2012年09月,台東縣,7545100,3,0.7619,2357355,372,0.2381,9902455
2012年09月,花蓮縣,71583500,19,0.8572,11928393,595,0.1428,83511893
2012年09月,基隆市,10864137,18,0.56,8535085,383,0.44,19399222
2012年09月,新竹市,572627296,132,0.9526,28473328,1773,0.0474,601100624
2012年09月,嘉義市,1882120,4,0.2621,5298474,674,0.7379,7180594
2012年09月,澎湖縣,1293600,1,0.3613,2286588,280,0.6387,3580188
2012年09月,金門縣,1691600,2,0.5482,1394321,174,0.4518,3085921
2012年09月,連江縣,0,0,0,455623,59,1,455623
2012年09月,合計,6638554112,3482,0.8122,1535421214,83524,0.1878,8173975326
2012年08月,新北市,238071821,229,0.4777,260277707,14364,0.5223,498349528
2012年08月,台北市,28391020,26,0.5669,21692207,1890,0.4331,50083227
2012年08月,桃園市,1413215787,747,0.8345,280190553,6775,0.1655,1693406340
2012年08月,台中市,949647688,390,0.802,234438853,10915,0.198,1184086541
2012年08月,台南市,1245246528,417,0.858,206035862,11245,0.142,1451282390
2012年08月,高雄市,1233560559,493,0.8857,159253555,6232,0.1143,1392814114
2012年08月,宜蘭縣,108397912,64,0.8033,26536525,1325,0.1967,134934437
2012年08月,新竹縣,542343497,210,0.9063,56068733,1459,0.0937,598412230
2012年08月,苗栗縣,381317440,141,0.9049,40070082,1315,0.0951,421387522
2012年08月,彰化縣,313017108,256,0.6358,179337788,16259,0.3642,492354896
2012年08月,南投縣,62452769,79,0.6708,30645578,1126,0.3292,93098347
2012年08月,雲林縣,192338280,81,0.834,38290629,2406,0.166,230628909
2012年08月,嘉義縣,43517980,60,0.5494,35689601,2075,0.4506,79207581
2012年08月,屏東縣,84369000,107,0.7243,32116569,1843,0.2757,116485569
2012年08月,台東縣,8895700,3,0.7799,2510070,372,0.2201,11405770
2012年08月,花蓮縣,82358400,19,0.8659,12755864,599,0.1341,95114264
2012年08月,基隆市,13162500,18,0.5984,8831851,384,0.4016,21994351
2012年08月,新竹市,656016924,133,0.9558,30307343,1778,0.0442,686324267
2012年08月,嘉義市,2215200,4,0.2854,5545297,675,0.7146,7760497
2012年08月,澎湖縣,1553600,1,0.3852,2479737,281,0.6148,4033337
2012年08月,金門縣,2036800,2,0.5764,1496800,172,0.4236,3533600
2012年08月,連江縣,0,0,0,497283,59,1,497283
2012年08月,合計,7602126513,3480,0.8203,1665068487,83549,0.1797,9267195000
2012年07月,新北市,227567460,231,0.4769,249570580,14365,0.5231,477138040
2012年07月,台北市,27725400,27,0.5761,20397613,1897,0.4239,48123013
2012年07月,桃園市,1387028631,753,0.8385,267167128,6770,0.1615,1654195759
2012年07月,台中市,877776332,391,0.7926,229748385,10919,0.2074,1107524717
2012年07月,台南市,1263103365,419,0.8628,200876393,11240,0.1372,1463979758
2012年07月,高雄市,1193311717,490,0.8821,159466358,6244,0.1179,1352778075
2012年07月,宜蘭縣,119441260,64,0.817,26752883,1322,0.183,146194143
2012年07月,新竹縣,543625746,211,0.8984,61464576,1464,0.1016,605090322
2012年07月,苗栗縣,370814765,141,0.9028,39936231,1315,0.0972,410750996
2012年07月,彰化縣,291467499,254,0.6304,170915507,16263,0.3696,462383006
2012年07月,南投縣,59879204,78,0.6629,30451082,1129,0.3371,90330286
2012年07月,雲林縣,191551000,80,0.8363,37503363,2412,0.1637,229054363
2012年07月,嘉義縣,45043040,60,0.5364,38930146,2074,0.4636,83973186
2012年07月,屏東縣,99141935,106,0.7575,31731039,1842,0.2425,130872974
2012年07月,台東縣,8893100,3,0.7784,2531832,373,0.2216,11424932
2012年07月,花蓮縣,89634400,19,0.8735,12975046,602,0.1265,102609446
2012年07月,基隆市,11896196,17,0.57,8974146,390,0.43,20870342
2012年07月,新竹市,656264045,132,0.9578,28940915,1776,0.0422,685204960
2012年07月,嘉義市,2586480,4,0.3238,5401533,674,0.6762,7988013
2012年07月,澎湖縣,1362000,1,0.3621,2399068,281,0.6379,3761068
2012年07月,金門縣,1862800,2,0.5812,1342188,171,0.4188,3204988
2012年07月,連江縣,0,0,0,468835,59,1,468835
2012年07月,合計,7469976375,3483,0.8211,1627944847,83582,0.1789,9097921222
2012年06月,合計,7905474332,3467,0.8299,1620264479,83621,0.1701,9525738811
2012年06月,新北市,208094540,230,0.474,230953990,14369,0.526,439048530
2012年06月,台北市,24773500,27,0.5692,18752436,1902,0.4308,43525936
2012年06月,桃園市,1257038562,752,0.8355,247556315,6751,0.1645,1504594877
2012年06月,台中市,836725072,388,0.7947,216120846,10914,0.2053,1052845918
2012年06月,台南市,1126882524,418,0.8557,190101746,11240,0.1443,1316984270
2012年06月,高雄市,1130376291,487,0.8835,149071289,6238,0.1165,1279447580
2012年06月,宜蘭縣,100944300,64,0.8129,23228424,1321,0.1871,124172724
2012年06月,新竹縣,483136225,212,0.9071,49479450,1475,0.0929,532615675
2012年06月,苗栗縣,362625160,141,0.9038,38579959,1305,0.0962,401205119
2012年06月,彰化縣,277550866,253,0.6261,165735571,16270,0.3739,443286437
2012年06月,南投縣,56714780,80,0.6693,28016897,1128,0.3307,84731677
2012年06月,雲林縣,173825460,80,0.8303,35534617,2419,0.1697,209360077
2012年06月,嘉義縣,37733240,58,0.5154,35476907,2070,0.4846,73210147
2012年06月,屏東縣,77256047,105,0.7207,29942579,1835,0.2793,107198626
2012年06月,台東縣,8339100,3,0.7949,2151980,372,0.2051,10491080
2012年06月,花蓮縣,70132700,19,0.8532,12067705,597,0.1468,82200405
2012年06月,基隆市,10922900,17,0.5719,8175569,395,0.4281,19098469
2012年06月,新竹市,591426760,131,0.9552,27720748,1781,0.0448,619147508
2012年06月,嘉義市,2379920,4,0.3109,5274958,675,0.6891,7654878
2012年06月,澎湖縣,1325200,1,0.3918,2057247,282,0.6082,3382447
2012年06月,金門縣,1524000,2,0.5464,1265285,170,0.4536,2789285
2012年06月,連江縣,0,0,0,387045,59,1,387045
2012年06月,合計,6839727147,3472,0.8184,1517651563,83568,0.1816,8357378710
2012年05月,新北市,233525220,228,0.5001,233423285,14360,0.4999,466948505
2012年05月,台北市,26465960,26,0.588,18544825,1911,0.412,45010785
2012年05月,桃園市,1471727545,757,0.8472,265486174,6738,0.1528,1737213719
2012年05月,台中市,966022448,387,0.8098,226874503,10924,0.1902,1192896951
2012年05月,台南市,1302616712,420,0.8645,204204648,11253,0.1355,1506821360
2012年05月,高雄市,1338355091,485,0.8931,160211252,6238,0.1069,1498566343
2012年05月,宜蘭縣,127954980,63,0.8261,26927586,1323,0.1739,154882566
2012年05月,新竹縣,549651317,212,0.9142,51613616,1469,0.0858,601264933
2012年05月,苗栗縣,428830944,141,0.9079,43515348,1307,0.0921,472346292
2012年05月,彰化縣,290758790,253,0.6232,175790829,16292,0.3768,466549619
2012年05月,南投縣,65866100,78,0.6807,30891468,1129,0.3193,96757568
2012年05月,雲林縣,199015520,80,0.8393,38111858,2426,0.1607,237127378
2012年05月,嘉義縣,45682240,57,0.477,50078415,2078,0.523,95760655
2012年05月,屏東縣,81665016,105,0.712,33027407,1836,0.288,114692423
2012年05月,台東縣,9883200,3,0.8038,2412538,375,0.1962,12295738
2012年05月,花蓮縣,85830300,19,0.8624,13692889,599,0.1376,99523189
2012年05月,基隆市,11874049,16,0.5859,8390925,397,0.4141,20264974
2012年05月,新竹市,663776460,130,0.9595,27992079,1780,0.0405,691768539
2012年05月,嘉義市,2746840,4,0.3493,5117107,676,0.6507,7863947
2012年05月,澎湖縣,1670000,1,0.4318,2197559,281,0.5682,3867559
2012年05月,金門縣,1555600,2,0.5448,1299532,170,0.4552,2855132
2012年05月,連江縣,0,0,0,460636,59,1,460636
2012年04月,新北市,203310955,228,0.4879,213415540,14377,0.5121,416726495
2012年04月,台北市,22907440,26,0.5779,16733972,1904,0.4221,39641412
2012年04月,桃園市,1262328389,755,0.8397,240941259,6716,0.1603,1503269648
2012年04月,台中市,841176543,381,0.8017,208022728,10929,0.1983,1049199271
2012年04月,台南市,1125237731,424,0.8586,185244059,11252,0.1414,1310481790
2012年04月,高雄市,1202876499,486,0.888,151773410,6224,0.112,1354649909
2012年04月,宜蘭縣,103681900,64,0.8056,25027472,1316,0.1944,128709372
2012年04月,新竹縣,472102949,211,0.9116,45787357,1465,0.0884,517890306
2012年04月,苗栗縣,379483022,141,0.9142,35614184,1310,0.0858,415097206
2012年04月,彰化縣,243746624,255,0.5972,164429181,16303,0.4028,408175805
2012年04月,南投縣,56323140,77,0.6669,28127079,1130,0.3331,84450219
2012年04月,雲林縣,173520700,79,0.8333,34701486,2428,0.1667,208222186
2012年04月,嘉義縣,43805180,56,0.5217,40162747,2079,0.4783,83967927
2012年04月,屏東縣,54260016,106,0.6445,29931210,1835,0.3555,84191226
2012年04月,台東縣,8666900,3,0.7983,2189750,375,0.2017,10856650
2012年04月,花蓮縣,80845200,18,0.8677,12328383,602,0.1323,93173583
2012年04月,基隆市,10712900,16,0.584,7632075,398,0.416,18344975
2012年04月,新竹市,567135300,131,0.9576,25092024,1783,0.0424,592227324
2012年04月,嘉義市,2177400,4,0.3074,4906633,678,0.6926,7084033
2012年04月,澎湖縣,1365600,1,0.4168,1910783,278,0.5832,3276383
2012年04月,金門縣,994400,2,0.4642,1147884,168,0.5358,2142284
2012年04月,連江縣,0,0,0,401022,59,1,401022
2012年04月,合計,6856658788,3464,0.8229,1475520238,83609,0.1771,8332179026
2012年03月,新北市,236026109,227,0.5265,212227121,14386,0.4735,448253230
2012年03月,台北市,26718080,26,0.6177,16538939,1911,0.3823,43257019
2012年03月,桃園市,1427721706,760,0.8475,256899960,6705,0.1525,1684621666
2012年03月,台中市,961390891,381,0.8152,218005594,10952,0.1848,1179396485
2012年03月,台南市,1279369626,424,0.8689,192965457,11246,0.1311,1472335083
2012年03月,高雄市,1393229347,489,0.8865,178308482,6224,0.1135,1571537829
2012年03月,宜蘭縣,122630438,66,0.8384,23639371,1316,0.1616,146269809
2012年03月,新竹縣,521686220,211,0.9178,46717644,1467,0.0822,568403864
2012年03月,苗栗縣,441465705,140,0.921,37847649,1307,0.079,479313354
2012年03月,彰化縣,278302348,250,0.6203,170345661,16314,0.3797,448648009
2012年03月,南投縣,61847100,77,0.6716,30236327,1127,0.3284,92083427
2012年03月,雲林縣,196139560,80,0.8453,35889279,2420,0.1547,232028839
2012年03月,嘉義縣,40319380,56,0.4632,46720228,2076,0.5368,87039608
2012年03月,屏東縣,60332096,104,0.658,31352482,1829,0.342,91684578
2012年03月,台東縣,9855600,3,0.8078,2344273,375,0.1922,12199873
2012年03月,花蓮縣,93245341,18,0.8773,13046689,602,0.1227,106292030
2012年03月,基隆市,12647786,16,0.6222,7680367,395,0.3778,20328153
2012年03月,新竹市,640452160,131,0.9632,24468359,1780,0.0368,664920519
2012年03月,嘉義市,2627720,4,0.365,4570765,680,0.635,7198485
2012年03月,澎湖縣,1706800,1,0.4639,1972552,277,0.5361,3679352
2012年03月,金門縣,723200,2,0.3708,1227207,168,0.6292,1950407
2012年03月,連江縣,0,0,0,494964,59,1,494964
2012年03月,合計,7808437213,3466,0.8341,1553499370,83616,0.1659,9361936583
2012年02月,新北市,162537867,230,0.4848,172750503,14391,0.5152,335288370
2012年02月,台北市,18646260,26,0.5667,14254750,1916,0.4333,32901010
2012年02月,桃園市,1012746478,761,0.8314,205445353,6695,0.1686,1218191831
2012年02月,台中市,658017880,379,0.7953,169339901,10944,0.2047,827357781
2012年02月,台南市,895251179,425,0.8532,154016602,11246,0.1468,1049267781
2012年02月,高雄市,955938846,485,0.8801,130175852,6225,0.1199,1086114698
2012年02月,宜蘭縣,81535127,66,0.8163,18349673,1318,0.1837,99884800
2012年02月,新竹縣,364825539,210,0.8932,43609483,1468,0.1068,408435022
2012年02月,苗栗縣,308356047,141,0.9154,28499608,1301,0.0846,336855655
2012年02月,彰化縣,215171024,250,0.614,135254009,16327,0.386,350425033
2012年02月,南投縣,41982460,77,0.6439,23218972,1128,0.3561,65201432
2012年02月,雲林縣,134642800,80,0.8267,28224000,2418,0.1733,162866800
2012年02月,嘉義縣,28137998,57,0.4594,33106033,2073,0.5406,61244031
2012年02月,屏東縣,40207020,102,0.6159,25073792,1834,0.3841,65280812
2012年02月,台東縣,6810700,3,0.7681,2056511,374,0.2319,8867211
2012年02月,花蓮縣,64776912,18,0.8621,10360054,600,0.1379,75136966
2012年02月,基隆市,8689400,18,0.5879,6090576,394,0.4121,14779976
2012年02月,新竹市,444443817,131,0.9564,20265854,1786,0.0436,464709671
2012年02月,嘉義市,1721200,4,0.2985,4044108,687,0.7015,5765308
2012年02月,澎湖縣,1255200,1,0.4371,1616488,277,0.5629,2871688
2012年02月,金門縣,530000,2,0.3456,1003558,167,0.6544,1533558
2012年02月,連江縣,0,0,0,352008,59,1,352008
2012年02月,合計,5446223754,3466,0.8161,1227107688,83628,0.1839,6673331442
2012年01月,新北市,187284300,230,0.5077,181612322,14397,0.4923,368896622
2012年01月,台北市,24233880,26,0.6151,15166394,1922,0.3849,39400274
2012年01月,桃園市,1198875167,760,0.8475,215675733,6698,0.1525,1414550900
2012年01月,台中市,818714952,376,0.8238,175118235,10956,0.1762,993833187
2012年01月,台南市,1124289064,424,0.8782,155936195,11252,0.1218,1280225259
2012年01月,高雄市,1140379317,484,0.892,138017485,6223,0.108,1278396802
2012年01月,宜蘭縣,102738720,66,0.8408,19445859,1319,0.1592,122184579
2012年01月,新竹縣,464849256,211,0.9167,42222824,1466,0.0833,507072080
2012年01月,苗栗縣,352171138,142,0.9192,30962996,1306,0.0808,383134134
2012年01月,彰化縣,272526650,250,0.6576,141881140,16335,0.3424,414407790
2012年01月,南投縣,48323160,75,0.6681,24008015,1132,0.3319,72331175
2012年01月,雲林縣,174983585,81,0.8556,29538105,2420,0.1444,204521690
2012年01月,嘉義縣,31553280,56,0.4804,34127643,2072,0.5196,65680923
2012年01月,屏東縣,47719720,104,0.6425,26551695,1831,0.3575,74271415
2012年01月,台東縣,7777200,3,0.7703,2319389,373,0.2297,10096589
2012年01月,花蓮縣,93576800,17,0.8769,13133147,600,0.1231,106709947
2012年01月,基隆市,10819040,18,0.6082,6970553,394,0.3918,17789593
2012年01月,新竹市,593285710,131,0.965,21496540,1790,0.035,614782250
2012年01月,嘉義市,1798600,4,0.3043,4111565,686,0.6957,5910165
2012年01月,澎湖縣,1638800,1,0.4802,1773592,285,0.5198,3412392
2012年01月,金門縣,589200,2,0.3356,1166283,167,0.6644,1755483
2012年01月,連江縣,0,0,0,433582,59,1,433582
2012年01月,合計,6698127539,3461,0.8394,1281669292,83683,0.1606,7979796831
